weekyear,Equipment Type,Container Size,Location,Export Units,Import Units,Imbalance
2022-01,Dry,20,A,64288,43744,-20544
2022-01,Dry,20,B,83952,129888,45936
2022-01,Dry,20,C,28832,33664,4832
2022-01,Dry,20,D,240,656,416
2022-01,Dry,20,E,7792,13632,5840
2022-01,Dry,20,F,12544,5008,-7536
2022-01,Dry,20,G,42848,13984,-28864
2022-01,Dry,40,A,88112,70384,-17728
2022-01,Dry,40,B,105712,174912,69200
2022-01,Dry,40,C,25248,42192,16944
2022-01,Dry,40,D,96,0,-96
2022-01,Dry,40,E,20368,19360,-1008
2022-01,Dry,40,F,25888,11664,-14224
2022-01,Dry,40,G,16752,15360,-1392
2022-01,Reefer,20,A,352,16,-336
2022-01,Reefer,20,B,160,608,448
2022-01,Reefer,20,C,80,96,16
2022-01,Reefer,20,E,16,32,16
2022-01,Reefer,20,F,544,0,-544
2022-01,Reefer,20,G,0,16,16
2022-01,Reefer,40,A,17648,4192,-13456
2022-01,Reefer,40,B,12768,20240,7472
2022-01,Reefer,40,C,4384,14768,10384
2022-01,Reefer,40,E,800,560,-240
2022-01,Reefer,40,F,5232,320,-4912
2022-01,Reefer,40,G,5936,2624,-3312
2022-02,Dry,20,A,54960,54000,-960
2022-02,Dry,20,B,105536,97440,-8096
2022-02,Dry,20,C,21632,22336,704
2022-02,Dry,20,D,0,384,384
2022-02,Dry,20,E,13648,14000,352
2022-02,Dry,20,F,9136,6352,-2784
2022-02,Dry,20,G,49248,11136,-38112
2022-02,Dry,40,A,69104,87712,18608
2022-02,Dry,40,B,142048,98608,-43440
2022-02,Dry,40,C,22224,29504,7280
2022-02,Dry,40,D,336,80,-256
2022-02,Dry,40,E,26592,21408,-5184
2022-02,Dry,40,F,17216,14944,-2272
2022-02,Dry,40,G,17424,16064,-1360
2022-02,Reefer,20,A,368,48,-320
2022-02,Reefer,20,B,416,80,-336
2022-02,Reefer,20,C,160,48,-112
2022-02,Reefer,20,E,208,0,-208
2022-02,Reefer,20,F,192,16,-176
2022-02,Reefer,40,A,9360,4320,-5040
2022-02,Reefer,40,B,15472,8080,-7392
2022-02,Reefer,40,C,4384,12192,7808
2022-02,Reefer,40,D,0,16,16
2022-02,Reefer,40,E,864,352,-512
2022-02,Reefer,40,F,2000,1008,-992
2022-02,Reefer,40,G,4496,2688,-1808
2022-03,Dry,20,A,70576,45680,-24896
2022-03,Dry,20,B,128192,101408,-26784
2022-03,Dry,20,C,19360,34096,14736
2022-03,Dry,20,E,11472,10864,-608
2022-03,Dry,20,F,11584,6784,-4800
2022-03,Dry,20,G,27584,10768,-16816
2022-03,Dry,40,A,84576,58176,-26400
2022-03,Dry,40,B,145520,118816,-26704
2022-03,Dry,40,C,25584,49472,23888
2022-03,Dry,40,D,0,64,64
2022-03,Dry,40,E,24384,20112,-4272
2022-03,Dry,40,F,15904,18480,2576
2022-03,Dry,40,G,12784,17744,4960
2022-03,Reefer,20,A,336,16,-320
2022-03,Reefer,20,B,432,304,-128
2022-03,Reefer,20,C,240,64,-176
2022-03,Reefer,20,E,112,0,-112
2022-03,Reefer,20,F,64,0,-64
2022-03,Reefer,20,G,80,32,-48
2022-03,Reefer,40,A,16304,4240,-12064
2022-03,Reefer,40,B,31760,32576,816
2022-03,Reefer,40,C,5648,17440,11792
2022-03,Reefer,40,E,576,624,48
2022-03,Reefer,40,F,2464,496,-1968
2022-03,Reefer,40,G,6640,2688,-3952
2022-04,Dry,20,A,73440,36816,-36624
2022-04,Dry,20,B,142832,95168,-47664
2022-04,Dry,20,C,14304,34496,20192
2022-04,Dry,20,D,0,128,128
2022-04,Dry,20,E,6144,8208,2064
2022-04,Dry,20,F,8528,2256,-6272
2022-04,Dry,20,G,58528,13776,-44752
2022-04,Dry,40,A,90800,69856,-20944
2022-04,Dry,40,B,165280,119104,-46176
2022-04,Dry,40,C,17280,45424,28144
2022-04,Dry,40,D,192,48,-144
2022-04,Dry,40,E,9728,20272,10544
2022-04,Dry,40,F,21632,4736,-16896
2022-04,Dry,40,G,22240,17920,-4320
2022-04,Reefer,20,A,448,32,-416
2022-04,Reefer,20,B,288,448,160
2022-04,Reefer,20,C,176,0,-176
2022-04,Reefer,20,F,336,48,-288
2022-04,Reefer,20,G,32,0,-32
2022-04,Reefer,40,A,19664,4960,-14704
2022-04,Reefer,40,B,16976,11888,-5088
2022-04,Reefer,40,C,4288,16624,12336
2022-04,Reefer,40,E,272,224,-48
2022-04,Reefer,40,F,6032,512,-5520
2022-04,Reefer,40,G,9360,1904,-7456
2022-05,Dry,20,A,46448,33328,-13120
2022-05,Dry,20,B,84848,117712,32864
2022-05,Dry,20,C,21008,28336,7328
2022-05,Dry,20,E,14112,18208,4096
2022-05,Dry,20,F,9776,9376,-400
2022-05,Dry,20,G,35984,5280,-30704
2022-05,Dry,40,A,77888,52576,-25312
2022-05,Dry,40,B,111664,113600,1936
2022-05,Dry,40,C,29840,54864,25024
2022-05,Dry,40,D,864,0,-864
2022-05,Dry,40,E,30176,31024,848
2022-05,Dry,40,F,24256,18992,-5264
2022-05,Dry,40,G,14672,12720,-1952
2022-05,Reefer,20,A,480,0,-480
2022-05,Reefer,20,B,352,208,-144
2022-05,Reefer,20,C,112,256,144
2022-05,Reefer,20,E,96,0,-96
2022-05,Reefer,20,F,96,0,-96
2022-05,Reefer,20,G,16,0,-16
2022-05,Reefer,40,A,18864,4176,-14688
2022-05,Reefer,40,B,12816,20320,7504
2022-05,Reefer,40,C,5760,16384,10624
2022-05,Reefer,40,E,1408,1184,-224
2022-05,Reefer,40,F,4384,1024,-3360
2022-05,Reefer,40,G,3424,2160,-1264
2022-06,Dry,20,A,65872,40160,-25712
2022-06,Dry,20,B,98336,110736,12400
2022-06,Dry,20,C,20848,39008,18160
2022-06,Dry,20,D,0,80,80
2022-06,Dry,20,E,18576,22768,4192
2022-06,Dry,20,F,7392,592,-6800
2022-06,Dry,20,G,63712,8496,-55216
2022-06,Dry,40,A,88864,60880,-27984
2022-06,Dry,40,B,120640,168016,47376
2022-06,Dry,40,C,21200,45888,24688
2022-06,Dry,40,D,784,256,-528
2022-06,Dry,40,E,32976,26464,-6512
2022-06,Dry,40,F,13152,2336,-10816
2022-06,Dry,40,G,23392,15984,-7408
2022-06,Reefer,20,A,576,32,-544
2022-06,Reefer,20,B,144,192,48
2022-06,Reefer,20,C,32,96,64
2022-06,Reefer,20,E,32,96,64
2022-06,Reefer,20,F,160,0,-160
2022-06,Reefer,20,G,192,16,-176
2022-06,Reefer,40,A,18608,4640,-13968
2022-06,Reefer,40,B,16960,16160,-800
2022-06,Reefer,40,C,3920,25536,21616
2022-06,Reefer,40,D,0,80,80
2022-06,Reefer,40,E,1392,752,-640
2022-06,Reefer,40,F,2272,192,-2080
2022-06,Reefer,40,G,9392,4032,-5360
2022-07,Dry,20,A,40976,30048,-10928
2022-07,Dry,20,B,125072,115552,-9520
2022-07,Dry,20,C,11472,14704,3232
2022-07,Dry,20,D,0,640,640
2022-07,Dry,20,E,11952,9136,-2816
2022-07,Dry,20,F,8272,6992,-1280
2022-07,Dry,20,G,41088,6512,-34576
2022-07,Dry,40,A,45840,57168,11328
2022-07,Dry,40,B,162128,147072,-15056
2022-07,Dry,40,C,19792,33184,13392
2022-07,Dry,40,D,640,144,-496
2022-07,Dry,40,E,18192,10928,-7264
2022-07,Dry,40,F,10688,15904,5216
2022-07,Dry,40,G,17344,15904,-1440
2022-07,Reefer,20,A,112,0,-112
2022-07,Reefer,20,B,112,224,112
2022-07,Reefer,20,C,128,0,-128
2022-07,Reefer,20,E,160,0,-160
2022-07,Reefer,20,F,16,16,0
2022-07,Reefer,20,G,48,0,-48
2022-07,Reefer,40,A,8752,3136,-5616
2022-07,Reefer,40,B,18912,20208,1296
2022-07,Reefer,40,C,6800,13824,7024
2022-07,Reefer,40,E,1264,1088,-176
2022-07,Reefer,40,F,1792,560,-1232
2022-07,Reefer,40,G,6608,960,-5648
2022-08,Dry,20,A,99312,41856,-57456
2022-08,Dry,20,B,88432,121648,33216
2022-08,Dry,20,C,22416,23728,1312
2022-08,Dry,20,D,0,16,16
2022-08,Dry,20,E,10768,17632,6864
2022-08,Dry,20,F,9088,3728,-5360
2022-08,Dry,20,G,44944,9008,-35936
2022-08,Dry,40,A,102032,60480,-41552
2022-08,Dry,40,B,97840,153872,56032
2022-08,Dry,40,C,24544,47824,23280
2022-08,Dry,40,D,0,32,32
2022-08,Dry,40,E,24624,17520,-7104
2022-08,Dry,40,F,25408,11360,-14048
2022-08,Dry,40,G,30016,16960,-13056
2022-08,Reefer,20,A,496,32,-464
2022-08,Reefer,20,B,432,160,-272
2022-08,Reefer,20,C,144,80,-64
2022-08,Reefer,20,E,128,32,-96
2022-08,Reefer,20,F,240,0,-240
2022-08,Reefer,20,G,48,16,-32
2022-08,Reefer,40,A,21536,2208,-19328
2022-08,Reefer,40,B,14032,11456,-2576
2022-08,Reefer,40,C,7024,10736,3712
2022-08,Reefer,40,E,880,1056,176
2022-08,Reefer,40,F,4960,1312,-3648
2022-08,Reefer,40,G,7104,3632,-3472
2022-09,Dry,20,A,63952,29264,-34688
2022-09,Dry,20,B,138080,129280,-8800
2022-09,Dry,20,C,16080,10640,-5440
2022-09,Dry,20,E,6480,18416,11936
2022-09,Dry,20,F,6960,5312,-1648
2022-09,Dry,20,G,64704,10480,-54224
2022-09,Dry,40,A,70384,46608,-23776
2022-09,Dry,40,B,164016,141840,-22176
2022-09,Dry,40,C,25312,39696,14384
2022-09,Dry,40,D,192,16,-176
2022-09,Dry,40,E,13712,25136,11424
2022-09,Dry,40,F,12800,13408,608
2022-09,Dry,40,G,21232,21648,416
2022-09,Reefer,20,A,448,16,-432
2022-09,Reefer,20,B,144,288,144
2022-09,Reefer,20,C,176,16,-160
2022-09,Reefer,20,E,32,16,-16
2022-09,Reefer,20,F,192,48,-144
2022-09,Reefer,20,G,80,0,-80
2022-09,Reefer,40,A,24368,5696,-18672
2022-09,Reefer,40,B,15824,19024,3200
2022-09,Reefer,40,C,9472,7440,-2032
2022-09,Reefer,40,E,112,576,464
2022-09,Reefer,40,F,2048,1696,-352
2022-09,Reefer,40,G,6816,3664,-3152
2022-10,Dry,20,A,70800,40256,-30544
2022-10,Dry,20,B,124720,106928,-17792
2022-10,Dry,20,C,23760,28848,5088
2022-10,Dry,20,D,0,624,624
2022-10,Dry,20,E,14048,24176,10128
2022-10,Dry,20,F,11536,6064,-5472
2022-10,Dry,20,G,38928,7424,-31504
2022-10,Dry,40,A,109936,64704,-45232
2022-10,Dry,40,B,140688,148816,8128
2022-10,Dry,40,C,29536,50992,21456
2022-10,Dry,40,D,368,0,-368
2022-10,Dry,40,E,28128,25072,-3056
2022-10,Dry,40,F,26832,16592,-10240
2022-10,Dry,40,G,28272,11904,-16368
2022-10,Reefer,20,A,400,0,-400
2022-10,Reefer,20,B,416,496,80
2022-10,Reefer,20,C,176,96,-80
2022-10,Reefer,20,E,48,0,-48
2022-10,Reefer,20,F,288,32,-256
2022-10,Reefer,20,G,16,0,-16
2022-10,Reefer,40,A,17008,4080,-12928
2022-10,Reefer,40,B,15840,8720,-7120
2022-10,Reefer,40,C,9344,23424,14080
2022-10,Reefer,40,D,0,32,32
2022-10,Reefer,40,E,1280,1136,-144
2022-10,Reefer,40,F,4400,544,-3856
2022-10,Reefer,40,G,9040,3024,-6016
2022-11,Dry,20,A,69200,43488,-25712
2022-11,Dry,20,B,98592,106880,8288
2022-11,Dry,20,C,17568,27488,9920
2022-11,Dry,20,D,0,1136,1136
2022-11,Dry,20,E,11184,18080,6896
2022-11,Dry,20,F,8976,3424,-5552
2022-11,Dry,20,G,14384,3456,-10928
2022-11,Dry,40,A,90560,76656,-13904
2022-11,Dry,40,B,119200,138240,19040
2022-11,Dry,40,C,30688,42368,11680
2022-11,Dry,40,D,608,32,-576
2022-11,Dry,40,E,27136,27248,112
2022-11,Dry,40,F,35984,5984,-30000
2022-11,Dry,40,G,8256,7184,-1072
2022-11,Reefer,20,A,192,16,-176
2022-11,Reefer,20,B,496,416,-80
2022-11,Reefer,20,C,32,64,32
2022-11,Reefer,20,E,32,32,0
2022-11,Reefer,20,F,32,0,-32
2022-11,Reefer,20,G,16,0,-16
2022-11,Reefer,40,A,16928,11184,-5744
2022-11,Reefer,40,B,18544,26032,7488
2022-11,Reefer,40,C,10896,21936,11040
2022-11,Reefer,40,E,1392,592,-800
2022-11,Reefer,40,F,4816,560,-4256
2022-11,Reefer,40,G,2624,1168,-1456
2022-12,Dry,20,A,46544,55152,8608
2022-12,Dry,20,B,78992,101040,22048
2022-12,Dry,20,C,13040,26000,12960
2022-12,Dry,20,D,0,784,784
2022-12,Dry,20,E,9504,12656,3152
2022-12,Dry,20,F,10016,7392,-2624
2022-12,Dry,20,G,23568,7856,-15712
2022-12,Dry,40,A,86288,60784,-25504
2022-12,Dry,40,B,106912,133168,26256
2022-12,Dry,40,C,28624,66736,38112
2022-12,Dry,40,D,1632,32,-1600
2022-12,Dry,40,E,15424,8736,-6688
2022-12,Dry,40,F,20752,13312,-7440
2022-12,Dry,40,G,12224,11680,-544
2022-12,Reefer,20,A,352,0,-352
2022-12,Reefer,20,B,240,176,-64
2022-12,Reefer,20,C,16,160,144
2022-12,Reefer,20,E,144,16,-128
2022-12,Reefer,20,F,48,16,-32
2022-12,Reefer,20,G,0,48,48
2022-12,Reefer,40,A,13760,8336,-5424
2022-12,Reefer,40,B,12160,8688,-3472
2022-12,Reefer,40,C,6416,25712,19296
2022-12,Reefer,40,E,1264,2816,1552
2022-12,Reefer,40,F,1616,1632,16
2022-12,Reefer,40,G,3552,4352,800
2022-13,Dry,20,A,80544,47536,-33008
2022-13,Dry,20,B,109296,96240,-13056
2022-13,Dry,20,C,21504,34064,12560
2022-13,Dry,20,D,0,32,32
2022-13,Dry,20,E,19376,21152,1776
2022-13,Dry,20,F,8736,8432,-304
2022-13,Dry,20,G,32832,12992,-19840
2022-13,Dry,40,A,103776,79472,-24304
2022-13,Dry,40,B,134864,90768,-44096
2022-13,Dry,40,C,21984,54416,32432
2022-13,Dry,40,D,1328,0,-1328
2022-13,Dry,40,E,38384,30240,-8144
2022-13,Dry,40,F,25024,21200,-3824
2022-13,Dry,40,G,17984,24144,6160
2022-13,Reefer,20,A,512,32,-480
2022-13,Reefer,20,B,32,368,336
2022-13,Reefer,20,C,144,96,-48
2022-13,Reefer,20,E,64,0,-64
2022-13,Reefer,20,F,272,96,-176
2022-13,Reefer,20,G,64,48,-16
2022-13,Reefer,40,A,22048,8064,-13984
2022-13,Reefer,40,B,21952,37120,15168
2022-13,Reefer,40,C,7472,27312,19840
2022-13,Reefer,40,E,720,640,-80
2022-13,Reefer,40,F,4912,1088,-3824
2022-13,Reefer,40,G,8112,6672,-1440
2022-14,Dry,20,A,46528,61040,14512
2022-14,Dry,20,B,101424,88336,-13088
2022-14,Dry,20,C,19360,27264,7904
2022-14,Dry,20,D,0,112,112
2022-14,Dry,20,E,11600,24544,12944
2022-14,Dry,20,F,13760,9216,-4544
2022-14,Dry,20,G,32672,12784,-19888
2022-14,Dry,40,A,70000,69072,-928
2022-14,Dry,40,B,129840,148240,18400
2022-14,Dry,40,C,40736,66432,25696
2022-14,Dry,40,D,1200,80,-1120
2022-14,Dry,40,E,20592,21904,1312
2022-14,Dry,40,F,25984,24672,-1312
2022-14,Dry,40,G,13792,14448,656
2022-14,Reefer,20,A,304,16,-288
2022-14,Reefer,20,B,400,160,-240
2022-14,Reefer,20,C,208,160,-48
2022-14,Reefer,20,E,16,0,-16
2022-14,Reefer,20,F,176,32,-144
2022-14,Reefer,20,G,96,32,-64
2022-14,Reefer,40,A,13936,5296,-8640
2022-14,Reefer,40,B,31008,31984,976
2022-14,Reefer,40,C,7152,17712,10560
2022-14,Reefer,40,D,0,96,96
2022-14,Reefer,40,E,576,1200,624
2022-14,Reefer,40,F,5664,1040,-4624
2022-14,Reefer,40,G,9360,3888,-5472
2022-15,Dry,20,A,64224,44336,-19888
2022-15,Dry,20,B,101712,120384,18672
2022-15,Dry,20,C,28672,46272,17600
2022-15,Dry,20,E,13536,14960,1424
2022-15,Dry,20,F,8112,6592,-1520
2022-15,Dry,20,G,38304,13440,-24864
2022-15,Dry,40,A,79536,68672,-10864
2022-15,Dry,40,B,116496,182336,65840
2022-15,Dry,40,C,34608,73248,38640
2022-15,Dry,40,D,112,0,-112
2022-15,Dry,40,E,28832,16752,-12080
2022-15,Dry,40,F,19536,8000,-11536
2022-15,Dry,40,G,18400,17872,-528
2022-15,Reefer,20,A,368,0,-368
2022-15,Reefer,20,B,64,272,208
2022-15,Reefer,20,C,80,16,-64
2022-15,Reefer,20,E,80,128,48
2022-15,Reefer,20,F,48,0,-48
2022-15,Reefer,40,A,22176,6400,-15776
2022-15,Reefer,40,B,26864,38128,11264
2022-15,Reefer,40,C,7776,20832,13056
2022-15,Reefer,40,D,0,16,16
2022-15,Reefer,40,E,960,848,-112
2022-15,Reefer,40,F,2336,256,-2080
2022-15,Reefer,40,G,6368,6800,432
2022-16,Dry,20,A,57840,44640,-13200
2022-16,Dry,20,B,108752,102576,-6176
2022-16,Dry,20,C,21088,32336,11248
2022-16,Dry,20,D,0,32,32
2022-16,Dry,20,E,15648,20464,4816
2022-16,Dry,20,F,9248,9984,736
2022-16,Dry,20,G,46464,16224,-30240
2022-16,Dry,40,A,104848,61792,-43056
2022-16,Dry,40,B,138368,126560,-11808
2022-16,Dry,40,C,28592,62352,33760
2022-16,Dry,40,D,720,80,-640
2022-16,Dry,40,E,38992,22784,-16208
2022-16,Dry,40,F,16432,19968,3536
2022-16,Dry,40,G,26400,18096,-8304
2022-16,Reefer,20,A,240,16,-224
2022-16,Reefer,20,B,416,160,-256
2022-16,Reefer,20,C,176,80,-96
2022-16,Reefer,20,E,96,16,-80
2022-16,Reefer,20,F,448,16,-432
2022-16,Reefer,20,G,0,16,16
2022-16,Reefer,40,A,18400,7824,-10576
2022-16,Reefer,40,B,33856,15936,-17920
2022-16,Reefer,40,C,7632,13072,5440
2022-16,Reefer,40,E,864,1056,192
2022-16,Reefer,40,F,2832,1120,-1712
2022-16,Reefer,40,G,4272,3088,-1184
2022-17,Dry,20,A,57280,38896,-18384
2022-17,Dry,20,B,113280,82016,-31264
2022-17,Dry,20,C,15168,30464,15296
2022-17,Dry,20,E,13648,19520,5872
2022-17,Dry,20,F,8224,5312,-2912
2022-17,Dry,20,G,32080,8432,-23648
2022-17,Dry,40,A,84752,54096,-30656
2022-17,Dry,40,B,164656,115904,-48752
2022-17,Dry,40,C,24672,54192,29520
2022-17,Dry,40,D,1392,16,-1376
2022-17,Dry,40,E,21184,26144,4960
2022-17,Dry,40,F,26960,10848,-16112
2022-17,Dry,40,G,14496,16896,2400
2022-17,Reefer,20,A,352,0,-352
2022-17,Reefer,20,B,368,128,-240
2022-17,Reefer,20,C,128,160,32
2022-17,Reefer,20,E,16,48,32
2022-17,Reefer,20,F,240,0,-240
2022-17,Reefer,20,G,32,160,128
2022-17,Reefer,40,A,18560,10736,-7824
2022-17,Reefer,40,B,19808,8640,-11168
2022-17,Reefer,40,C,4864,20288,15424
2022-17,Reefer,40,D,0,32,32
2022-17,Reefer,40,E,432,832,400
2022-17,Reefer,40,F,3056,912,-2144
2022-17,Reefer,40,G,5760,2560,-3200
2022-18,Dry,20,A,53664,46848,-6816
2022-18,Dry,20,B,94336,75888,-18448
2022-18,Dry,20,C,19040,32800,13760
2022-18,Dry,20,D,0,208,208
2022-18,Dry,20,E,12816,28288,15472
2022-18,Dry,20,F,9904,14976,5072
2022-18,Dry,20,G,81552,7104,-74448
2022-18,Dry,40,A,74896,62336,-12560
2022-18,Dry,40,B,158944,142096,-16848
2022-18,Dry,40,C,30848,62544,31696
2022-18,Dry,40,D,640,96,-544
2022-18,Dry,40,E,26208,24656,-1552
2022-18,Dry,40,F,13872,30176,16304
2022-18,Dry,40,G,22512,14720,-7792
2022-18,Reefer,20,A,192,16,-176
2022-18,Reefer,20,B,48,288,240
2022-18,Reefer,20,C,80,160,80
2022-18,Reefer,20,E,128,16,-112
2022-18,Reefer,20,F,48,48,0
2022-18,Reefer,20,G,112,16,-96
2022-18,Reefer,40,A,11296,6832,-4464
2022-18,Reefer,40,B,21584,29408,7824
2022-18,Reefer,40,C,4976,24608,19632
2022-18,Reefer,40,D,16,0,-16
2022-18,Reefer,40,E,720,2928,2208
2022-18,Reefer,40,F,1392,960,-432
2022-18,Reefer,40,G,8432,1472,-6960
2022-19,Dry,20,A,63056,49312,-13744
2022-19,Dry,20,B,89840,106368,16528
2022-19,Dry,20,C,11056,30048,18992
2022-19,Dry,20,D,0,64,64
2022-19,Dry,20,E,15632,29664,14032
2022-19,Dry,20,F,11888,6704,-5184
2022-19,Dry,20,G,51856,8064,-43792
2022-19,Dry,40,A,109328,84576,-24752
2022-19,Dry,40,B,136816,165424,28608
2022-19,Dry,40,C,15360,52096,36736
2022-19,Dry,40,D,208,0,-208
2022-19,Dry,40,E,29440,34160,4720
2022-19,Dry,40,F,35984,16752,-19232
2022-19,Dry,40,G,23728,17280,-6448
2022-19,Reefer,20,A,432,16,-416
2022-19,Reefer,20,B,64,192,128
2022-19,Reefer,20,C,96,64,-32
2022-19,Reefer,20,E,16,48,32
2022-19,Reefer,20,F,304,16,-288
2022-19,Reefer,20,G,80,16,-64
2022-19,Reefer,40,A,17568,7760,-9808
2022-19,Reefer,40,B,19648,18464,-1184
2022-19,Reefer,40,C,4496,17232,12736
2022-19,Reefer,40,D,0,32,32
2022-19,Reefer,40,E,496,1184,688
2022-19,Reefer,40,F,4912,1520,-3392
2022-19,Reefer,40,G,7248,1216,-6032
2022-20,Dry,20,A,70128,45328,-24800
2022-20,Dry,20,B,118096,122480,4384
2022-20,Dry,20,C,30240,25696,-4544
2022-20,Dry,20,D,0,16,16
2022-20,Dry,20,E,15680,21936,6256
2022-20,Dry,20,F,6432,8768,2336
2022-20,Dry,20,G,67040,9280,-57760
2022-20,Dry,40,A,99904,66880,-33024
2022-20,Dry,40,B,159120,130768,-28352
2022-20,Dry,40,C,44544,41504,-3040
2022-20,Dry,40,D,400,16,-384
2022-20,Dry,40,E,33600,27120,-6480
2022-20,Dry,40,F,18192,22160,3968
2022-20,Dry,40,G,25968,18800,-7168
2022-20,Reefer,20,A,512,32,-480
2022-20,Reefer,20,B,768,720,-48
2022-20,Reefer,20,C,176,64,-112
2022-20,Reefer,20,E,112,64,-48
2022-20,Reefer,20,G,112,48,-64
2022-20,Reefer,40,A,19312,8448,-10864
2022-20,Reefer,40,B,18512,14592,-3920
2022-20,Reefer,40,C,7280,25088,17808
2022-20,Reefer,40,D,0,16,16
2022-20,Reefer,40,E,1360,3904,2544
2022-20,Reefer,40,F,2608,784,-1824
2022-20,Reefer,40,G,7808,1440,-6368
2022-21,Dry,20,A,60336,39776,-20560
2022-21,Dry,20,B,88096,123744,35648
2022-21,Dry,20,C,21376,25072,3696
2022-21,Dry,20,D,0,848,848
2022-21,Dry,20,E,3600,8672,5072
2022-21,Dry,20,F,13392,6960,-6432
2022-21,Dry,20,G,75440,13280,-62160
2022-21,Dry,40,A,82944,47760,-35184
2022-21,Dry,40,B,172256,163424,-8832
2022-21,Dry,40,C,22800,47056,24256
2022-21,Dry,40,D,2224,880,-1344
2022-21,Dry,40,E,7440,9632,2192
2022-21,Dry,40,F,21632,18704,-2928
2022-21,Dry,40,G,29456,15888,-13568
2022-21,Reefer,20,A,672,16,-656
2022-21,Reefer,20,B,496,528,32
2022-21,Reefer,20,C,224,96,-128
2022-21,Reefer,20,E,16,0,-16
2022-21,Reefer,20,F,384,80,-304
2022-21,Reefer,20,G,96,16,-80
2022-21,Reefer,40,A,17856,6336,-11520
2022-21,Reefer,40,B,14928,17632,2704
2022-21,Reefer,40,C,5280,20832,15552
2022-21,Reefer,40,E,560,768,208
2022-21,Reefer,40,F,2848,1248,-1600
2022-21,Reefer,40,G,6880,1632,-5248
2022-22,Dry,20,A,33296,37584,4288
2022-22,Dry,20,B,138336,117424,-20912
2022-22,Dry,20,C,12304,36064,23760
2022-22,Dry,20,E,8880,9488,608
2022-22,Dry,20,F,5520,8224,2704
2022-22,Dry,20,G,45696,9936,-35760
2022-22,Dry,40,A,63824,60416,-3408
2022-22,Dry,40,B,166096,122448,-43648
2022-22,Dry,40,C,21408,62288,40880
2022-22,Dry,40,D,32,0,-32
2022-22,Dry,40,E,21872,16480,-5392
2022-22,Dry,40,F,13376,11104,-2272
2022-22,Dry,40,G,18816,16512,-2304
2022-22,Reefer,20,A,160,0,-160
2022-22,Reefer,20,B,592,400,-192
2022-22,Reefer,20,C,48,48,0
2022-22,Reefer,20,E,128,64,-64
2022-22,Reefer,20,F,80,0,-80
2022-22,Reefer,20,G,0,96,96
2022-22,Reefer,40,A,10288,6368,-3920
2022-22,Reefer,40,B,15616,15072,-544
2022-22,Reefer,40,C,6528,22176,15648
2022-22,Reefer,40,D,0,16,16
2022-22,Reefer,40,E,624,528,-96
2022-22,Reefer,40,F,2576,736,-1840
2022-22,Reefer,40,G,3856,976,-2880
2022-23,Dry,20,A,54976,44352,-10624
2022-23,Dry,20,B,110672,83168,-27504
2022-23,Dry,20,C,19568,30656,11088
2022-23,Dry,20,E,10992,21872,10880
2022-23,Dry,20,F,9600,7168,-2432
2022-23,Dry,20,G,83792,11920,-71872
2022-23,Dry,40,A,84304,66080,-18224
2022-23,Dry,40,B,159072,132096,-26976
2022-23,Dry,40,C,23424,51408,27984
2022-23,Dry,40,D,304,16,-288
2022-23,Dry,40,E,27312,20512,-6800
2022-23,Dry,40,F,32544,12848,-19696
2022-23,Dry,40,G,29968,23152,-6816
2022-23,Reefer,20,A,208,32,-176
2022-23,Reefer,20,B,192,176,-16
2022-23,Reefer,20,C,80,144,64
2022-23,Reefer,20,E,80,64,-16
2022-23,Reefer,20,F,224,0,-224
2022-23,Reefer,20,G,16,0,-16
2022-23,Reefer,40,A,15120,6464,-8656
2022-23,Reefer,40,B,15856,25360,9504
2022-23,Reefer,40,C,4160,26096,21936
2022-23,Reefer,40,D,0,32,32
2022-23,Reefer,40,E,1152,2432,1280
2022-23,Reefer,40,F,3088,368,-2720
2022-23,Reefer,40,G,8640,1840,-6800
2022-24,Dry,20,A,43856,45744,1888
2022-24,Dry,20,B,119280,123168,3888
2022-24,Dry,20,C,21488,30832,9344
2022-24,Dry,20,D,0,48,48
2022-24,Dry,20,E,11136,12096,960
2022-24,Dry,20,F,7536,9840,2304
2022-24,Dry,20,G,63408,9072,-54336
2022-24,Dry,40,A,63536,64320,784
2022-24,Dry,40,B,133744,122320,-11424
2022-24,Dry,40,C,23072,45520,22448
2022-24,Dry,40,D,688,0,-688
2022-24,Dry,40,E,15136,18224,3088
2022-24,Dry,40,F,22528,21184,-1344
2022-24,Dry,40,G,16752,20208,3456
2022-24,Reefer,20,A,336,0,-336
2022-24,Reefer,20,B,640,640,0
2022-24,Reefer,20,C,80,16,-64
2022-24,Reefer,20,E,128,32,-96
2022-24,Reefer,20,F,32,144,112
2022-24,Reefer,20,G,48,32,-16
2022-24,Reefer,40,A,11664,3904,-7760
2022-24,Reefer,40,B,25488,11280,-14208
2022-24,Reefer,40,C,3920,15280,11360
2022-24,Reefer,40,D,0,32,32
2022-24,Reefer,40,E,768,1952,1184
2022-24,Reefer,40,F,1984,1216,-768
2022-24,Reefer,40,G,5440,1168,-4272
2022-25,Dry,20,A,51344,37904,-13440
2022-25,Dry,20,B,93920,124800,30880
2022-25,Dry,20,C,14128,25520,11392
2022-25,Dry,20,D,0,80,80
2022-25,Dry,20,E,14320,18128,3808
2022-25,Dry,20,F,7872,6432,-1440
2022-25,Dry,20,G,50496,6528,-43968
2022-25,Dry,40,A,78080,43344,-34736
2022-25,Dry,40,B,136048,147248,11200
2022-25,Dry,40,C,26640,47632,20992
2022-25,Dry,40,D,240,0,-240
2022-25,Dry,40,E,31552,20704,-10848
2022-25,Dry,40,F,19152,17616,-1536
2022-25,Dry,40,G,21776,12592,-9184
2022-25,Reefer,20,A,112,16,-96
2022-25,Reefer,20,B,272,480,208
2022-25,Reefer,20,C,176,224,48
2022-25,Reefer,20,E,32,16,-16
2022-25,Reefer,20,F,384,0,-384
2022-25,Reefer,20,G,48,16,-32
2022-25,Reefer,40,A,15168,3968,-11200
2022-25,Reefer,40,B,12560,13600,1040
2022-25,Reefer,40,C,3440,24672,21232
2022-25,Reefer,40,E,1216,1520,304
2022-25,Reefer,40,F,3600,816,-2784
2022-25,Reefer,40,G,4032,368,-3664
2022-26,Dry,20,A,67680,46800,-20880
2022-26,Dry,20,B,141728,86112,-55616
2022-26,Dry,20,C,23776,31584,7808
2022-26,Dry,20,D,0,16,16
2022-26,Dry,20,E,8176,15616,7440
2022-26,Dry,20,F,8416,7536,-880
2022-26,Dry,20,G,50976,7616,-43360
2022-26,Dry,40,A,79168,50880,-28288
2022-26,Dry,40,B,155280,127328,-27952
2022-26,Dry,40,C,31488,51808,20320
2022-26,Dry,40,D,96,432,336
2022-26,Dry,40,E,10048,17728,7680
2022-26,Dry,40,F,19680,10000,-9680
2022-26,Dry,40,G,18112,16624,-1488
2022-26,Reefer,20,A,320,0,-320
2022-26,Reefer,20,B,176,192,16
2022-26,Reefer,20,C,288,112,-176
2022-26,Reefer,20,E,80,16,-64
2022-26,Reefer,20,F,16,32,16
2022-26,Reefer,20,G,16,0,-16
2022-26,Reefer,40,A,13280,4160,-9120
2022-26,Reefer,40,B,12928,21872,8944
2022-26,Reefer,40,C,5792,16080,10288
2022-26,Reefer,40,E,672,2512,1840
2022-26,Reefer,40,F,3456,800,-2656
2022-26,Reefer,40,G,5072,1536,-3536
2022-27,Dry,20,A,48912,32928,-15984
2022-27,Dry,20,B,122976,118080,-4896
2022-27,Dry,20,C,14832,35952,21120
2022-27,Dry,20,D,16,912,896
2022-27,Dry,20,E,16528,25056,8528
2022-27,Dry,20,F,8256,6976,-1280
2022-27,Dry,20,G,58400,11456,-46944
2022-27,Dry,40,A,84960,64576,-20384
2022-27,Dry,40,B,139632,147440,7808
2022-27,Dry,40,C,21552,50464,28912
2022-27,Dry,40,D,992,1264,272
2022-27,Dry,40,E,41440,28512,-12928
2022-27,Dry,40,F,23536,15408,-8128
2022-27,Dry,40,G,18048,23408,5360
2022-27,Reefer,20,A,368,0,-368
2022-27,Reefer,20,B,608,528,-80
2022-27,Reefer,20,C,48,32,-16
2022-27,Reefer,20,E,48,16,-32
2022-27,Reefer,20,F,464,16,-448
2022-27,Reefer,20,G,64,80,16
2022-27,Reefer,40,A,13344,1536,-11808
2022-27,Reefer,40,B,26016,14880,-11136
2022-27,Reefer,40,C,4016,17904,13888
2022-27,Reefer,40,D,0,32,32
2022-27,Reefer,40,E,1136,1888,752
2022-27,Reefer,40,F,2640,2016,-624
2022-27,Reefer,40,G,6768,832,-5936
2022-28,Dry,20,A,61328,30720,-30608
2022-28,Dry,20,B,124128,106496,-17632
2022-28,Dry,20,C,20752,18304,-2448
2022-28,Dry,20,D,0,928,928
2022-28,Dry,20,E,1392,4784,3392
2022-28,Dry,20,F,10000,6128,-3872
2022-28,Dry,20,G,42096,7488,-34608
2022-28,Dry,40,A,73632,51648,-21984
2022-28,Dry,40,B,156128,143264,-12864
2022-28,Dry,40,C,21600,21056,-544
2022-28,Dry,40,D,16,1088,1072
2022-28,Dry,40,E,2896,8384,5488
2022-28,Dry,40,F,25840,14864,-10976
2022-28,Dry,40,G,16880,14432,-2448
2022-28,Reefer,20,A,240,0,-240
2022-28,Reefer,20,B,912,704,-208
2022-28,Reefer,20,C,112,240,128
2022-28,Reefer,20,F,80,0,-80
2022-28,Reefer,20,G,80,32,-48
2022-28,Reefer,40,A,16048,4192,-11856
2022-28,Reefer,40,B,15280,14496,-784
2022-28,Reefer,40,C,5328,19056,13728
2022-28,Reefer,40,E,16,320,304
2022-28,Reefer,40,F,3984,1072,-2912
2022-28,Reefer,40,G,5520,1344,-4176
2022-29,Dry,20,A,63584,44704,-18880
2022-29,Dry,20,B,93216,85712,-7504
2022-29,Dry,20,C,23264,29840,6576
2022-29,Dry,20,D,16,0,-16
2022-29,Dry,20,E,11776,20176,8400
2022-29,Dry,20,F,7216,6272,-944
2022-29,Dry,20,G,43840,7232,-36608
2022-29,Dry,40,A,94096,67632,-26464
2022-29,Dry,40,B,127200,124320,-2880
2022-29,Dry,40,C,24384,45472,21088
2022-29,Dry,40,D,496,16,-480
2022-29,Dry,40,E,23824,19152,-4672
2022-29,Dry,40,F,15536,13872,-1664
2022-29,Dry,40,G,19648,16992,-2656
2022-29,Reefer,20,A,448,16,-432
2022-29,Reefer,20,B,432,448,16
2022-29,Reefer,20,C,192,96,-96
2022-29,Reefer,20,E,32,96,64
2022-29,Reefer,20,F,32,0,-32
2022-29,Reefer,20,G,96,16,-80
2022-29,Reefer,40,A,18960,1856,-17104
2022-29,Reefer,40,B,11264,11792,528
2022-29,Reefer,40,C,6864,10064,3200
2022-29,Reefer,40,E,1392,1136,-256
2022-29,Reefer,40,F,3008,1568,-1440
2022-29,Reefer,40,G,7696,1904,-5792
2022-30,Dry,20,A,51920,45328,-6592
2022-30,Dry,20,B,107712,115216,7504
2022-30,Dry,20,C,19504,33520,14016
2022-30,Dry,20,D,0,16,16
2022-30,Dry,20,E,12048,18544,6496
2022-30,Dry,20,F,8720,4416,-4304
2022-30,Dry,20,G,56672,13088,-43584
2022-30,Dry,40,A,76176,72592,-3584
2022-30,Dry,40,B,134912,140960,6048
2022-30,Dry,40,C,29936,54672,24736
2022-30,Dry,40,D,480,0,-480
2022-30,Dry,40,E,23104,14896,-8208
2022-30,Dry,40,F,16832,8352,-8480
2022-30,Dry,40,G,14848,23520,8672
2022-30,Reefer,20,A,272,0,-272
2022-30,Reefer,20,B,384,256,-128
2022-30,Reefer,20,C,64,272,208
2022-30,Reefer,20,E,272,16,-256
2022-30,Reefer,20,F,432,16,-416
2022-30,Reefer,20,G,16,48,32
2022-30,Reefer,40,A,19584,3520,-16064
2022-30,Reefer,40,B,12000,10688,-1312
2022-30,Reefer,40,C,5328,10304,4976
2022-30,Reefer,40,E,896,1424,528
2022-30,Reefer,40,F,2944,992,-1952
2022-30,Reefer,40,G,3984,944,-3040
2022-31,Dry,20,A,48384,26112,-22272
2022-31,Dry,20,B,86368,120320,33952
2022-31,Dry,20,C,10560,38384,27824
2022-31,Dry,20,D,0,576,576
2022-31,Dry,20,E,14960,30224,15264
2022-31,Dry,20,F,6608,6496,-112
2022-31,Dry,20,G,69056,4592,-64464
2022-31,Dry,40,A,68096,49792,-18304
2022-31,Dry,40,B,129760,135200,5440
2022-31,Dry,40,C,16736,68192,51456
2022-31,Dry,40,D,352,720,368
2022-31,Dry,40,E,27584,51904,24320
2022-31,Dry,40,F,29712,11712,-18000
2022-31,Dry,40,G,21504,8480,-13024
2022-31,Reefer,20,A,160,0,-160
2022-31,Reefer,20,B,128,688,560
2022-31,Reefer,20,C,128,64,-64
2022-31,Reefer,20,E,64,176,112
2022-31,Reefer,20,F,336,0,-336
2022-31,Reefer,20,G,144,48,-96
2022-31,Reefer,40,A,15424,2160,-13264
2022-31,Reefer,40,B,12096,12960,864
2022-31,Reefer,40,C,3648,11184,7536
2022-31,Reefer,40,E,496,1152,656
2022-31,Reefer,40,F,5136,656,-4480
2022-31,Reefer,40,G,7792,1232,-6560
2022-32,Dry,20,A,57152,34048,-23104
2022-32,Dry,20,B,133136,107376,-25760
2022-32,Dry,20,C,21808,27488,5680
2022-32,Dry,20,D,16,352,336
2022-32,Dry,20,E,12608,20928,8320
2022-32,Dry,20,F,12080,7008,-5072
2022-32,Dry,20,G,47632,11984,-35648
2022-32,Dry,40,A,81424,61968,-19456
2022-32,Dry,40,B,129616,125376,-4240
2022-32,Dry,40,C,20144,38128,17984
2022-32,Dry,40,D,112,544,432
2022-32,Dry,40,E,23424,24880,1456
2022-32,Dry,40,F,19632,19152,-480
2022-32,Dry,40,G,18288,24304,6016
2022-32,Reefer,20,A,416,32,-384
2022-32,Reefer,20,B,992,608,-384
2022-32,Reefer,20,C,48,48,0
2022-32,Reefer,20,E,192,144,-48
2022-32,Reefer,20,F,320,80,-240
2022-32,Reefer,20,G,64,16,-48
2022-32,Reefer,40,A,18240,4464,-13776
2022-32,Reefer,40,B,9648,13504,3856
2022-32,Reefer,40,C,3920,6672,2752
2022-32,Reefer,40,E,928,2272,1344
2022-32,Reefer,40,F,3664,1552,-2112
2022-32,Reefer,40,G,6656,816,-5840
2022-33,Dry,20,A,57888,39936,-17952
2022-33,Dry,20,B,90144,103744,13600
2022-33,Dry,20,C,14976,23968,8992
2022-33,Dry,20,D,0,16,16
2022-33,Dry,20,E,14400,22960,8560
2022-33,Dry,20,F,4368,5184,816
2022-33,Dry,20,G,32448,8384,-24064
2022-33,Dry,40,A,77264,56160,-21104
2022-33,Dry,40,B,124672,127632,2960
2022-33,Dry,40,C,25648,45872,20224
2022-33,Dry,40,D,816,0,-816
2022-33,Dry,40,E,26112,30896,4784
2022-33,Dry,40,F,15872,12096,-3776
2022-33,Dry,40,G,17968,16400,-1568
2022-33,Reefer,20,A,320,0,-320
2022-33,Reefer,20,B,496,608,112
2022-33,Reefer,20,C,128,112,-16
2022-33,Reefer,20,E,96,80,-16
2022-33,Reefer,20,F,160,16,-144
2022-33,Reefer,20,G,16,32,16
2022-33,Reefer,40,A,14976,1920,-13056
2022-33,Reefer,40,B,15968,24320,8352
2022-33,Reefer,40,C,4288,13600,9312
2022-33,Reefer,40,E,912,912,0
2022-33,Reefer,40,F,2240,896,-1344
2022-33,Reefer,40,G,5728,688,-5040
2022-34,Dry,20,A,44560,33712,-10848
2022-34,Dry,20,B,103984,91136,-12848
2022-34,Dry,20,C,24240,32688,8448
2022-34,Dry,20,D,0,464,464
2022-34,Dry,20,E,12720,29616,16896
2022-34,Dry,20,F,6832,7408,576
2022-34,Dry,20,G,32144,13104,-19040
2022-34,Dry,40,A,64704,68176,3472
2022-34,Dry,40,B,118464,106960,-11504
2022-34,Dry,40,C,22304,60176,37872
2022-34,Dry,40,D,976,192,-784
2022-34,Dry,40,E,18032,35504,17472
2022-34,Dry,40,F,19040,13552,-5488
2022-34,Dry,40,G,18016,22368,4352
2022-34,Reefer,20,A,368,0,-368
2022-34,Reefer,20,B,480,368,-112
2022-34,Reefer,20,C,160,96,-64
2022-34,Reefer,20,E,48,80,32
2022-34,Reefer,20,F,64,0,-64
2022-34,Reefer,20,G,0,96,96
2022-34,Reefer,40,A,15552,5472,-10080
2022-34,Reefer,40,B,25920,17648,-8272
2022-34,Reefer,40,C,5504,13152,7648
2022-34,Reefer,40,E,272,736,464
2022-34,Reefer,40,F,3472,1088,-2384
2022-34,Reefer,40,G,5776,1904,-3872
2022-35,Dry,20,A,50752,31776,-18976
2022-35,Dry,20,B,104592,109536,4944
2022-35,Dry,20,C,14000,28480,14480
2022-35,Dry,20,D,0,192,192
2022-35,Dry,20,E,8160,20048,11888
2022-35,Dry,20,F,5152,5904,752
2022-35,Dry,20,G,34288,14832,-19456
2022-35,Dry,40,A,79104,53200,-25904
2022-35,Dry,40,B,138752,133728,-5024
2022-35,Dry,40,C,16640,41584,24944
2022-35,Dry,40,D,0,48,48
2022-35,Dry,40,E,13424,21136,7712
2022-35,Dry,40,F,19808,13792,-6016
2022-35,Dry,40,G,11248,31072,19824
2022-35,Reefer,20,A,320,16,-304
2022-35,Reefer,20,B,480,336,-144
2022-35,Reefer,20,C,192,80,-112
2022-35,Reefer,20,E,192,48,-144
2022-35,Reefer,20,F,512,80,-432
2022-35,Reefer,20,G,80,128,48
2022-35,Reefer,40,A,16240,3088,-13152
2022-35,Reefer,40,B,15456,19584,4128
2022-35,Reefer,40,C,5056,4032,-1024
2022-35,Reefer,40,E,576,1664,1088
2022-35,Reefer,40,F,4032,1584,-2448
2022-35,Reefer,40,G,6608,1360,-5248
2022-36,Dry,20,A,63728,41120,-22608
2022-36,Dry,20,B,102320,77632,-24688
2022-36,Dry,20,C,22960,26768,3808
2022-36,Dry,20,D,0,496,496
2022-36,Dry,20,E,14144,16336,2192
2022-36,Dry,20,F,5648,9696,4048
2022-36,Dry,20,G,28496,6880,-21616
2022-36,Dry,40,A,92672,62624,-30048
2022-36,Dry,40,B,119520,126336,6816
2022-36,Dry,40,C,20160,54016,33856
2022-36,Dry,40,D,608,848,240
2022-36,Dry,40,E,30096,26000,-4096
2022-36,Dry,40,F,17824,13472,-4352
2022-36,Dry,40,G,15072,14512,-560
2022-36,Reefer,20,A,384,32,-352
2022-36,Reefer,20,B,320,192,-128
2022-36,Reefer,20,C,144,192,48
2022-36,Reefer,20,E,32,64,32
2022-36,Reefer,20,F,112,32,-80
2022-36,Reefer,20,G,32,0,-32
2022-36,Reefer,40,A,19280,5168,-14112
2022-36,Reefer,40,B,19888,23200,3312
2022-36,Reefer,40,C,5008,13632,8624
2022-36,Reefer,40,E,1232,288,-944
2022-36,Reefer,40,F,4624,736,-3888
2022-36,Reefer,40,G,6832,784,-6048
2022-37,Dry,20,A,53360,34032,-19328
2022-37,Dry,20,B,87520,96160,8640
2022-37,Dry,20,C,27552,26176,-1376
2022-37,Dry,20,D,0,352,352
2022-37,Dry,20,E,11152,23888,12736
2022-37,Dry,20,F,9904,7440,-2464
2022-37,Dry,20,G,28000,6960,-21040
2022-37,Dry,40,A,67648,51232,-16416
2022-37,Dry,40,B,128080,141424,13344
2022-37,Dry,40,C,26032,47168,21136
2022-37,Dry,40,D,576,336,-240
2022-37,Dry,40,E,21536,39264,17728
2022-37,Dry,40,F,20800,14304,-6496
2022-37,Dry,40,G,17456,18400,944
2022-37,Reefer,20,A,384,0,-384
2022-37,Reefer,20,B,208,352,144
2022-37,Reefer,20,C,176,64,-112
2022-37,Reefer,20,E,48,128,80
2022-37,Reefer,20,F,400,16,-384
2022-37,Reefer,20,G,48,32,-16
2022-37,Reefer,40,A,14464,2432,-12032
2022-37,Reefer,40,B,20496,18544,-1952
2022-37,Reefer,40,C,6448,13360,6912
2022-37,Reefer,40,E,480,1680,1200
2022-37,Reefer,40,F,4608,1040,-3568
2022-37,Reefer,40,G,6096,1248,-4848
2022-38,Dry,20,A,49840,27456,-22384
2022-38,Dry,20,B,107024,108016,992
2022-38,Dry,20,C,12720,27248,14528
2022-38,Dry,20,D,16,544,528
2022-38,Dry,20,E,12192,19856,7664
2022-38,Dry,20,F,6144,3952,-2192
2022-38,Dry,20,G,26080,10144,-15936
2022-38,Dry,40,A,66096,46416,-19680
2022-38,Dry,40,B,161184,132592,-28592
2022-38,Dry,40,C,16112,50304,34192
2022-38,Dry,40,D,992,704,-288
2022-38,Dry,40,E,20064,20336,272
2022-38,Dry,40,F,13936,11584,-2352
2022-38,Dry,40,G,12864,18896,6032
2022-38,Reefer,20,A,320,0,-320
2022-38,Reefer,20,B,304,352,48
2022-38,Reefer,20,C,80,48,-32
2022-38,Reefer,20,E,176,16,-160
2022-38,Reefer,20,F,80,0,-80
2022-38,Reefer,20,G,0,64,64
2022-38,Reefer,40,A,14464,6544,-7920
2022-38,Reefer,40,B,27120,22048,-5072
2022-38,Reefer,40,C,3280,15488,12208
2022-38,Reefer,40,E,1456,1456,0
2022-38,Reefer,40,F,2528,928,-1600
2022-38,Reefer,40,G,6736,2656,-4080
2022-39,Dry,20,A,54576,30544,-24032
2022-39,Dry,20,B,107920,101280,-6640
2022-39,Dry,20,C,22768,30288,7520
2022-39,Dry,20,D,80,384,304
2022-39,Dry,20,E,14496,29888,15392
2022-39,Dry,20,F,9744,4688,-5056
2022-39,Dry,20,G,26912,8064,-18848
2022-39,Dry,40,A,71440,58576,-12864
2022-39,Dry,40,B,124608,106032,-18576
2022-39,Dry,40,C,20592,53296,32704
2022-39,Dry,40,D,1824,368,-1456
2022-39,Dry,40,E,27152,33280,6128
2022-39,Dry,40,F,15440,11872,-3568
2022-39,Dry,40,G,17616,22832,5216
2022-39,Reefer,20,A,288,0,-288
2022-39,Reefer,20,B,240,176,-64
2022-39,Reefer,20,C,144,112,-32
2022-39,Reefer,20,E,64,112,48
2022-39,Reefer,20,F,336,16,-320
2022-39,Reefer,20,G,48,48,0
2022-39,Reefer,40,A,18080,1504,-16576
2022-39,Reefer,40,B,24592,24384,-208
2022-39,Reefer,40,C,5840,18016,12176
2022-39,Reefer,40,E,784,1312,528
2022-39,Reefer,40,F,2944,656,-2288
2022-39,Reefer,40,G,6800,1760,-5040
2022-40,Dry,20,A,60592,42288,-18304
2022-40,Dry,20,B,90576,93536,2960
2022-40,Dry,20,C,19792,27456,7664
2022-40,Dry,20,D,112,416,304
2022-40,Dry,20,E,9952,15584,5632
2022-40,Dry,20,F,8784,5264,-3520
2022-40,Dry,20,G,30272,6976,-23296
2022-40,Dry,40,A,92608,65088,-27520
2022-40,Dry,40,B,122816,128688,5872
2022-40,Dry,40,C,27104,45472,18368
2022-40,Dry,40,D,160,288,128
2022-40,Dry,40,E,16800,19360,2560
2022-40,Dry,40,F,20160,10752,-9408
2022-40,Dry,40,G,18240,16544,-1696
2022-40,Reefer,20,A,496,16,-480
2022-40,Reefer,20,B,416,192,-224
2022-40,Reefer,20,C,112,144,32
2022-40,Reefer,20,E,16,80,64
2022-40,Reefer,20,F,544,16,-528
2022-40,Reefer,20,G,176,0,-176
2022-40,Reefer,40,A,16576,1648,-14928
2022-40,Reefer,40,B,27056,25088,-1968
2022-40,Reefer,40,C,11536,16736,5200
2022-40,Reefer,40,E,784,768,-16
2022-40,Reefer,40,F,3872,1184,-2688
2022-40,Reefer,40,G,8160,1248,-6912
2022-41,Dry,20,A,51360,25904,-25456
2022-41,Dry,20,B,95680,87040,-8640
2022-41,Dry,20,C,13920,29056,15136
2022-41,Dry,20,D,592,160,-432
2022-41,Dry,20,E,12944,30368,17424
2022-41,Dry,20,F,9648,3904,-5744
2022-41,Dry,20,G,23824,8608,-15216
2022-41,Dry,40,A,96512,38176,-58336
2022-41,Dry,40,B,128976,119776,-9200
2022-41,Dry,40,C,20352,49792,29440
2022-41,Dry,40,D,640,208,-432
2022-41,Dry,40,E,28944,47584,18640
2022-41,Dry,40,F,25696,9696,-16000
2022-41,Dry,40,G,15536,15312,-224
2022-41,Reefer,20,A,544,0,-544
2022-41,Reefer,20,B,112,304,192
2022-41,Reefer,20,C,80,256,176
2022-41,Reefer,20,E,96,224,128
2022-41,Reefer,20,F,368,32,-336
2022-41,Reefer,20,G,64,48,-16
2022-41,Reefer,40,A,19168,9488,-9680
2022-41,Reefer,40,B,16992,20176,3184
2022-41,Reefer,40,C,6352,30352,24000
2022-41,Reefer,40,E,560,1104,544
2022-41,Reefer,40,F,6112,1488,-4624
2022-41,Reefer,40,G,3984,2832,-1152
2022-42,Dry,20,A,61056,31632,-29424
2022-42,Dry,20,B,99504,121568,22064
2022-42,Dry,20,C,24176,30320,6144
2022-42,Dry,20,D,576,16,-560
2022-42,Dry,20,E,8128,20032,11904
2022-42,Dry,20,F,8192,1152,-7040
2022-42,Dry,20,G,19728,5088,-14640
2022-42,Dry,40,A,88256,47136,-41120
2022-42,Dry,40,B,118496,156960,38464
2022-42,Dry,40,C,22608,48352,25744
2022-42,Dry,40,D,464,16,-448
2022-42,Dry,40,E,21232,31888,10656
2022-42,Dry,40,F,17232,1952,-15280
2022-42,Dry,40,G,12240,9008,-3232
2022-42,Reefer,20,A,512,48,-464
2022-42,Reefer,20,B,304,144,-160
2022-42,Reefer,20,C,112,48,-64
2022-42,Reefer,20,E,64,96,32
2022-42,Reefer,20,F,128,0,-128
2022-42,Reefer,20,G,48,48,0
2022-42,Reefer,40,A,19264,1344,-17920
2022-42,Reefer,40,B,22464,19520,-2944
2022-42,Reefer,40,C,9616,14848,5232
2022-42,Reefer,40,E,672,528,-144
2022-42,Reefer,40,F,3312,240,-3072
2022-42,Reefer,40,G,5952,2352,-3600
2022-43,Dry,20,A,50864,26464,-24400
2022-43,Dry,20,B,79536,81424,1888
2022-43,Dry,20,C,23568,21648,-1920
2022-43,Dry,20,E,15776,17632,1856
2022-43,Dry,20,F,9664,8288,-1376
2022-43,Dry,20,G,29168,6912,-22256
2022-43,Dry,40,A,77568,53536,-24032
2022-43,Dry,40,B,126272,102640,-23632
2022-43,Dry,40,C,23120,35392,12272
2022-43,Dry,40,D,192,0,-192
2022-43,Dry,40,E,31408,22336,-9072
2022-43,Dry,40,F,21312,21888,576
2022-43,Dry,40,G,17712,14768,-2944
2022-43,Reefer,20,A,432,32,-400
2022-43,Reefer,20,B,80,624,544
2022-43,Reefer,20,C,160,176,16
2022-43,Reefer,20,E,80,112,32
2022-43,Reefer,20,F,304,48,-256
2022-43,Reefer,20,G,32,0,-32
2022-43,Reefer,40,A,19536,5760,-13776
2022-43,Reefer,40,B,13488,13344,-144
2022-43,Reefer,40,C,17280,4272,-13008
2022-43,Reefer,40,E,1280,784,-496
2022-43,Reefer,40,F,2816,1264,-1552
2022-43,Reefer,40,G,8432,2112,-6320
2022-44,Dry,20,A,66480,41344,-25136
2022-44,Dry,20,B,117488,83024,-34464
2022-44,Dry,20,C,13488,37888,24400
2022-44,Dry,20,D,608,96,-512
2022-44,Dry,20,E,9104,12688,3584
2022-44,Dry,20,F,8640,6304,-2336
2022-44,Dry,20,G,30528,6048,-24480
2022-44,Dry,40,A,72880,70224,-2656
2022-44,Dry,40,B,123616,122960,-656
2022-44,Dry,40,C,16784,42768,25984
2022-44,Dry,40,D,672,272,-400
2022-44,Dry,40,E,14112,12320,-1792
2022-44,Dry,40,F,16480,6464,-10016
2022-44,Dry,40,G,13872,13104,-768
2022-44,Reefer,20,A,400,32,-368
2022-44,Reefer,20,B,736,160,-576
2022-44,Reefer,20,C,192,16,-176
2022-44,Reefer,20,E,64,32,-32
2022-44,Reefer,20,F,336,96,-240
2022-44,Reefer,20,G,112,16,-96
2022-44,Reefer,40,A,15392,3680,-11712
2022-44,Reefer,40,B,14352,15232,880
2022-44,Reefer,40,C,8928,8064,-864
2022-44,Reefer,40,E,512,432,-80
2022-44,Reefer,40,F,4288,560,-3728
2022-44,Reefer,40,G,5552,1200,-4352
2022-45,Dry,20,A,52368,28448,-23920
2022-45,Dry,20,B,81520,80304,-1216
2022-45,Dry,20,C,14272,12416,-1856
2022-45,Dry,20,E,13920,21984,8064
2022-45,Dry,20,F,9504,5472,-4032
2022-45,Dry,20,G,31200,8128,-23072
2022-45,Dry,40,A,76096,43440,-32656
2022-45,Dry,40,B,132240,102112,-30128
2022-45,Dry,40,C,18720,26848,8128
2022-45,Dry,40,D,16,176,160
2022-45,Dry,40,E,31824,37328,5504
2022-45,Dry,40,F,19872,19264,-608
2022-45,Dry,40,G,15168,18016,2848
2022-45,Reefer,20,A,144,0,-144
2022-45,Reefer,20,B,96,288,192
2022-45,Reefer,20,C,32,80,48
2022-45,Reefer,20,E,16,192,176
2022-45,Reefer,20,F,368,48,-320
2022-45,Reefer,20,G,112,0,-112
2022-45,Reefer,40,A,17504,2304,-15200
2022-45,Reefer,40,B,15008,10944,-4064
2022-45,Reefer,40,C,14048,8896,-5152
2022-45,Reefer,40,D,0,16,16
2022-45,Reefer,40,E,1168,592,-576
2022-45,Reefer,40,F,2976,816,-2160
2022-45,Reefer,40,G,9664,3600,-6064
2022-46,Dry,20,A,54640,24480,-30160
2022-46,Dry,20,B,76096,106480,30384
2022-46,Dry,20,C,27280,24016,-3264
2022-46,Dry,20,D,192,592,400
2022-46,Dry,20,E,13344,18576,5232
2022-46,Dry,20,F,6800,1584,-5216
2022-46,Dry,20,G,26000,3984,-22016
2022-46,Dry,40,A,64224,45504,-18720
2022-46,Dry,40,B,102304,119552,17248
2022-46,Dry,40,C,33408,36176,2768
2022-46,Dry,40,D,1216,512,-704
2022-46,Dry,40,E,21424,22864,1440
2022-46,Dry,40,F,11840,1888,-9952
2022-46,Dry,40,G,13200,9840,-3360
2022-46,Reefer,20,A,384,96,-288
2022-46,Reefer,20,B,592,656,64
2022-46,Reefer,20,C,144,160,16
2022-46,Reefer,20,E,32,32,0
2022-46,Reefer,20,F,144,0,-144
2022-46,Reefer,20,G,32,96,64
2022-46,Reefer,40,A,14912,5856,-9056
2022-46,Reefer,40,B,15696,16272,576
2022-46,Reefer,40,C,15760,13472,-2288
2022-46,Reefer,40,E,656,720,64
2022-46,Reefer,40,F,1504,384,-1120
2022-46,Reefer,40,G,8640,2096,-6544
2022-47,Dry,20,A,76000,27264,-48736
2022-47,Dry,20,B,69904,71776,1872
2022-47,Dry,20,C,15888,12544,-3344
2022-47,Dry,20,E,11312,9744,-1568
2022-47,Dry,20,F,9920,3536,-6384
2022-47,Dry,20,G,33136,9136,-24000
2022-47,Dry,40,A,83888,44320,-39568
2022-47,Dry,40,B,101440,74576,-26864
2022-47,Dry,40,C,20928,22368,1440
2022-47,Dry,40,D,64,480,416
2022-47,Dry,40,E,23184,7264,-15920
2022-47,Dry,40,F,16192,9920,-6272
2022-47,Dry,40,G,13264,21840,8576
2022-47,Reefer,20,A,384,32,-352
2022-47,Reefer,20,B,304,176,-128
2022-47,Reefer,20,C,48,48,0
2022-47,Reefer,20,E,80,0,-80
2022-47,Reefer,20,F,496,32,-464
2022-47,Reefer,20,G,128,16,-112
2022-47,Reefer,40,A,18832,2064,-16768
2022-47,Reefer,40,B,8176,4336,-3840
2022-47,Reefer,40,C,15920,6848,-9072
2022-47,Reefer,40,E,880,576,-304
2022-47,Reefer,40,F,4000,624,-3376
2022-47,Reefer,40,G,10400,1472,-8928
2022-48,Dry,20,A,41024,35664,-5360
2022-48,Dry,20,B,105424,113200,7776
2022-48,Dry,20,C,19648,29600,9952
2022-48,Dry,20,D,304,64,-240
2022-48,Dry,20,E,14864,20112,5248
2022-48,Dry,20,F,12272,2368,-9904
2022-48,Dry,20,G,25456,4368,-21088
2022-48,Dry,40,A,62112,66464,4352
2022-48,Dry,40,B,119952,145728,25776
2022-48,Dry,40,C,24336,48352,24016
2022-48,Dry,40,D,2496,192,-2304
2022-48,Dry,40,E,36976,29232,-7744
2022-48,Dry,40,F,18208,9424,-8784
2022-48,Dry,40,G,14096,11344,-2752
2022-48,Reefer,20,A,352,16,-336
2022-48,Reefer,20,B,368,400,32
2022-48,Reefer,20,C,288,240,-48
2022-48,Reefer,20,E,144,32,-112
2022-48,Reefer,20,F,128,32,-96
2022-48,Reefer,20,G,16,80,64
2022-48,Reefer,40,A,14640,6672,-7968
2022-48,Reefer,40,B,16688,22000,5312
2022-48,Reefer,40,C,16288,9728,-6560
2022-48,Reefer,40,E,1408,544,-864
2022-48,Reefer,40,F,3552,832,-2720
2022-48,Reefer,40,G,6464,2192,-4272
2022-49,Dry,20,A,59664,31536,-28128
2022-49,Dry,20,B,106208,122656,16448
2022-49,Dry,20,C,27568,16864,-10704
2022-49,Dry,20,D,0,64,64
2022-49,Dry,20,E,12656,21120,8464
2022-49,Dry,20,F,8688,7264,-1424
2022-49,Dry,20,G,19216,6080,-13136
2022-49,Dry,40,A,91744,68304,-23440
2022-49,Dry,40,B,126272,160032,33760
2022-49,Dry,40,C,29424,31328,1904
2022-49,Dry,40,D,272,256,-16
2022-49,Dry,40,E,31456,29632,-1824
2022-49,Dry,40,F,14976,20176,5200
2022-49,Dry,40,G,12848,17824,4976
2022-49,Reefer,20,A,528,48,-480
2022-49,Reefer,20,B,480,656,176
2022-49,Reefer,20,C,176,176,0
2022-49,Reefer,20,E,48,16,-32
2022-49,Reefer,20,F,64,16,-48
2022-49,Reefer,20,G,192,64,-128
2022-49,Reefer,40,A,19408,5088,-14320
2022-49,Reefer,40,B,17120,14448,-2672
2022-49,Reefer,40,C,13056,11648,-1408
2022-49,Reefer,40,D,0,48,48
2022-49,Reefer,40,E,1600,688,-912
2022-49,Reefer,40,F,1904,592,-1312
2022-49,Reefer,40,G,3968,2096,-1872
2022-50,Dry,20,A,62352,31104,-31248
2022-50,Dry,20,B,114800,80864,-33936
2022-50,Dry,20,C,16944,38368,21424
2022-50,Dry,20,D,112,16,-96
2022-50,Dry,20,E,11680,15776,4096
2022-50,Dry,20,F,11424,5520,-5904
2022-50,Dry,20,G,23904,8976,-14928
2022-50,Dry,40,A,90512,53968,-36544
2022-50,Dry,40,B,127600,96576,-31024
2022-50,Dry,40,C,18576,44816,26240
2022-50,Dry,40,D,768,48,-720
2022-50,Dry,40,E,24560,17072,-7488
2022-50,Dry,40,F,24080,12528,-11552
2022-50,Dry,40,G,10704,29104,18400
2022-50,Reefer,20,A,608,16,-592
2022-50,Reefer,20,B,240,240,0
2022-50,Reefer,20,C,176,208,32
2022-50,Reefer,20,E,96,64,-32
2022-50,Reefer,20,F,400,0,-400
2022-50,Reefer,20,G,224,0,-224
2022-50,Reefer,40,A,18848,6192,-12656
2022-50,Reefer,40,B,18640,26416,7776
2022-50,Reefer,40,C,13488,12224,-1264
2022-50,Reefer,40,E,992,400,-592
2022-50,Reefer,40,F,3840,880,-2960
2022-50,Reefer,40,G,9824,2000,-7824
2022-51,Dry,20,A,48896,22432,-26464
2022-51,Dry,20,B,82480,96144,13664
2022-51,Dry,20,C,23552,13072,-10480
2022-51,Dry,20,D,0,112,112
2022-51,Dry,20,E,9232,9264,32
2022-51,Dry,20,F,6704,4464,-2240
2022-51,Dry,20,G,22720,3872,-18848
2022-51,Dry,40,A,74400,35568,-38832
2022-51,Dry,40,B,113776,125520,11744
2022-51,Dry,40,C,23872,22816,-1056
2022-51,Dry,40,D,896,96,-800
2022-51,Dry,40,E,15216,8784,-6432
2022-51,Dry,40,F,16080,13296,-2784
2022-51,Dry,40,G,11680,9904,-1776
2022-51,Reefer,20,A,592,16,-576
2022-51,Reefer,20,B,576,288,-288
2022-51,Reefer,20,C,80,224,144
2022-51,Reefer,20,E,128,16,-112
2022-51,Reefer,20,F,192,64,-128
2022-51,Reefer,40,A,14656,5824,-8832
2022-51,Reefer,40,B,19200,12896,-6304
2022-51,Reefer,40,C,10064,13936,3872
2022-51,Reefer,40,D,0,32,32
2022-51,Reefer,40,E,608,304,-304
2022-51,Reefer,40,F,2912,576,-2336
2022-51,Reefer,40,G,5056,1072,-3984
2022-52,Dry,20,A,41632,31808,-9824
2022-52,Dry,20,B,69024,99248,30224
2022-52,Dry,20,C,18848,12592,-6256
2022-52,Dry,20,D,0,80,80
2022-52,Dry,20,E,12784,15536,2752
2022-52,Dry,20,F,6480,3520,-2960
2022-52,Dry,20,G,16368,4480,-11888
2022-52,Dry,40,A,57568,43888,-13680
2022-52,Dry,40,B,81408,120496,39088
2022-52,Dry,40,C,22464,16160,-6304
2022-52,Dry,40,D,416,48,-368
2022-52,Dry,40,E,33232,21680,-11552
2022-52,Dry,40,F,17280,15056,-2224
2022-52,Dry,40,G,10784,13792,3008
2022-52,Reefer,20,A,384,32,-352
2022-52,Reefer,20,B,96,896,800
2022-52,Reefer,20,C,256,96,-160
2022-52,Reefer,20,E,32,64,32
2022-52,Reefer,20,F,64,16,-48
2022-52,Reefer,20,G,0,16,16
2022-52,Reefer,40,A,12448,1296,-11152
2022-52,Reefer,40,B,10208,10224,16
2022-52,Reefer,40,C,7328,18320,10992
2022-52,Reefer,40,E,1040,400,-640
2022-52,Reefer,40,F,2768,656,-2112
2022-52,Reefer,40,G,3648,2608,-1040
2023-01,Dry,20,A,50864,35296,-15568
2023-01,Dry,20,B,121920,133984,12064
2023-01,Dry,20,C,16640,29408,12768
2023-01,Dry,20,D,0,64,64
2023-01,Dry,20,E,9024,11440,2416
2023-01,Dry,20,F,8864,5232,-3632
2023-01,Dry,20,G,37152,14192,-22960
2023-01,Dry,40,A,73392,66864,-6528
2023-01,Dry,40,B,134032,140176,6144
2023-01,Dry,40,C,20016,34832,14816
2023-01,Dry,40,D,96,64,-32
2023-01,Dry,40,E,26768,13936,-12832
2023-01,Dry,40,F,18592,19696,1104
2023-01,Dry,40,G,13168,28816,15648
2023-01,Reefer,20,A,512,0,-512
2023-01,Reefer,20,B,432,240,-192
2023-01,Reefer,20,C,128,112,-16
2023-01,Reefer,20,E,16,80,64
2023-01,Reefer,20,F,240,16,-224
2023-01,Reefer,20,G,32,32,0
2023-01,Reefer,40,A,11472,9216,-2256
2023-01,Reefer,40,B,22704,17952,-4752
2023-01,Reefer,40,C,10272,8736,-1536
2023-01,Reefer,40,D,0,48,48
2023-01,Reefer,40,E,704,512,-192
2023-01,Reefer,40,F,1776,720,-1056
2023-01,Reefer,40,G,7856,1776,-6080
2023-02,Dry,20,A,35232,28832,-6400
2023-02,Dry,20,B,110176,75296,-34880
2023-02,Dry,20,C,16016,24912,8896
2023-02,Dry,20,D,160,32,-128
2023-02,Dry,20,E,5312,12496,7184
2023-02,Dry,20,F,6816,2304,-4512
2023-02,Dry,20,G,10944,15344,4400
2023-02,Dry,40,A,59104,40768,-18336
2023-02,Dry,40,B,123312,75856,-47456
2023-02,Dry,40,C,13456,35968,22512
2023-02,Dry,40,D,448,112,-336
2023-02,Dry,40,E,8240,9904,1664
2023-02,Dry,40,F,16032,9344,-6688
2023-02,Dry,40,G,7120,28640,21520
2023-02,Reefer,20,A,288,0,-288
2023-02,Reefer,20,B,704,80,-624
2023-02,Reefer,20,C,128,208,80
2023-02,Reefer,20,E,64,16,-48
2023-02,Reefer,20,F,80,0,-80
2023-02,Reefer,20,G,0,48,48
2023-02,Reefer,40,A,12688,3184,-9504
2023-02,Reefer,40,B,7040,7184,144
2023-02,Reefer,40,C,5680,13968,8288
2023-02,Reefer,40,E,880,240,-640
2023-02,Reefer,40,F,3072,592,-2480
2023-02,Reefer,40,G,2448,2384,-64
2023-03,Dry,20,A,39488,18976,-20512
2023-03,Dry,20,B,100992,104816,3824
2023-03,Dry,20,C,20256,20688,432
2023-03,Dry,20,D,0,144,144
2023-03,Dry,20,E,12256,20880,8624
2023-03,Dry,20,F,7440,3296,-4144
2023-03,Dry,20,G,24208,8384,-15824
2023-03,Dry,40,A,51216,36880,-14336
2023-03,Dry,40,B,116320,127184,10864
2023-03,Dry,40,C,23888,20752,-3136
2023-03,Dry,40,D,1200,208,-992
2023-03,Dry,40,E,21600,20912,-688
2023-03,Dry,40,F,18736,9824,-8912
2023-03,Dry,40,G,14640,20736,6096
2023-03,Reefer,20,A,160,16,-144
2023-03,Reefer,20,B,160,144,-16
2023-03,Reefer,20,C,128,16,-112
2023-03,Reefer,20,E,48,112,64
2023-03,Reefer,20,F,368,16,-352
2023-03,Reefer,20,G,48,48,0
2023-03,Reefer,40,A,12336,7056,-5280
2023-03,Reefer,40,B,8496,12032,3536
2023-03,Reefer,40,C,5488,13456,7968
2023-03,Reefer,40,E,1056,464,-592
2023-03,Reefer,40,F,4048,528,-3520
2023-03,Reefer,40,G,9696,2176,-7520
2023-04,Dry,20,A,60464,32464,-28000
2023-04,Dry,20,B,115776,120400,4624
2023-04,Dry,20,C,26592,28672,2080
2023-04,Dry,20,D,208,96,-112
2023-04,Dry,20,E,15536,20416,4880
2023-04,Dry,20,F,4608,2368,-2240
2023-04,Dry,20,G,25472,11648,-13824
2023-04,Dry,40,A,80608,56816,-23792
2023-04,Dry,40,B,140992,136160,-4832
2023-04,Dry,40,C,25616,24448,-1168
2023-04,Dry,40,D,1104,16,-1088
2023-04,Dry,40,E,32528,23152,-9376
2023-04,Dry,40,F,10992,2000,-8992
2023-04,Dry,40,G,15744,20752,5008
2023-04,Reefer,20,A,464,16,-448
2023-04,Reefer,20,B,128,288,160
2023-04,Reefer,20,C,272,48,-224
2023-04,Reefer,20,E,224,32,-192
2023-04,Reefer,20,F,240,0,-240
2023-04,Reefer,40,A,15760,4944,-10816
2023-04,Reefer,40,B,15056,12464,-2592
2023-04,Reefer,40,C,11120,18512,7392
2023-04,Reefer,40,D,32,0,-32
2023-04,Reefer,40,E,1552,928,-624
2023-04,Reefer,40,F,1952,336,-1616
2023-04,Reefer,40,G,7136,1552,-5584
2023-05,Dry,20,A,63904,33808,-30096
2023-05,Dry,20,B,114832,119792,4960
2023-05,Dry,20,C,10416,32704,22288
2023-05,Dry,20,E,9200,13168,3968
2023-05,Dry,20,F,9008,7568,-1440
2023-05,Dry,20,G,20976,5296,-15680
2023-05,Dry,40,A,75024,66048,-8976
2023-05,Dry,40,B,129712,128384,-1328
2023-05,Dry,40,C,11968,46864,34896
2023-05,Dry,40,D,480,192,-288
2023-05,Dry,40,E,26592,19376,-7216
2023-05,Dry,40,F,17568,22672,5104
2023-05,Dry,40,G,14912,9488,-5424
2023-05,Reefer,20,A,400,32,-368
2023-05,Reefer,20,B,192,96,-96
2023-05,Reefer,20,C,192,304,112
2023-05,Reefer,20,E,128,80,-48
2023-05,Reefer,20,F,144,64,-80
2023-05,Reefer,40,A,14464,8240,-6224
2023-05,Reefer,40,B,14144,16128,1984
2023-05,Reefer,40,C,4896,13056,8160
2023-05,Reefer,40,D,96,0,-96
2023-05,Reefer,40,E,576,464,-112
2023-05,Reefer,40,F,3008,1680,-1328
2023-05,Reefer,40,G,6304,656,-5648
2023-06,Dry,20,A,56864,32992,-23872
2023-06,Dry,20,B,93312,93184,-128
2023-06,Dry,20,C,18016,19024,1008
2023-06,Dry,20,D,320,112,-208
2023-06,Dry,20,E,14128,19680,5552
2023-06,Dry,20,F,5712,4080,-1632
2023-06,Dry,20,G,25456,9296,-16160
2023-06,Dry,40,A,73344,47408,-25936
2023-06,Dry,40,B,105328,112416,7088
2023-06,Dry,40,C,26576,34128,7552
2023-06,Dry,40,D,1728,112,-1616
2023-06,Dry,40,E,28976,19552,-9424
2023-06,Dry,40,F,14064,13248,-816
2023-06,Dry,40,G,12944,16208,3264
2023-06,Reefer,20,A,464,32,-432
2023-06,Reefer,20,B,256,80,-176
2023-06,Reefer,20,C,304,208,-96
2023-06,Reefer,20,E,128,16,-112
2023-06,Reefer,20,F,192,32,-160
2023-06,Reefer,20,G,96,80,-16
2023-06,Reefer,40,A,13504,5744,-7760
2023-06,Reefer,40,B,12208,13904,1696
2023-06,Reefer,40,C,7200,26880,19680
2023-06,Reefer,40,D,32,16,-16
2023-06,Reefer,40,E,816,1104,288
2023-06,Reefer,40,F,1648,688,-960
2023-06,Reefer,40,G,6032,2224,-3808
2023-07,Dry,20,A,54704,29008,-25696
2023-07,Dry,20,B,118368,114016,-4352
2023-07,Dry,20,C,20560,23408,2848
2023-07,Dry,20,D,144,96,-48
2023-07,Dry,20,E,11744,13488,1744
2023-07,Dry,20,F,9328,6672,-2656
2023-07,Dry,20,G,31760,13392,-18368
2023-07,Dry,40,A,68992,47104,-21888
2023-07,Dry,40,B,105248,112960,7712
2023-07,Dry,40,C,22624,41184,18560
2023-07,Dry,40,D,592,48,-544
2023-07,Dry,40,E,24144,10192,-13952
2023-07,Dry,40,F,13696,15776,2080
2023-07,Dry,40,G,18880,22800,3920
2023-07,Reefer,20,A,288,0,-288
2023-07,Reefer,20,B,80,192,112
2023-07,Reefer,20,C,160,16,-144
2023-07,Reefer,20,E,224,0,-224
2023-07,Reefer,20,F,272,80,-192
2023-07,Reefer,20,G,16,16,0
2023-07,Reefer,40,A,14176,6976,-7200
2023-07,Reefer,40,B,23600,17952,-5648
2023-07,Reefer,40,C,10688,8032,-2656
2023-07,Reefer,40,D,0,32,32
2023-07,Reefer,40,E,976,512,-464
2023-07,Reefer,40,F,2304,896,-1408
2023-07,Reefer,40,G,6352,2016,-4336
2023-08,Dry,20,A,58416,44000,-14416
2023-08,Dry,20,B,121040,152192,31152
2023-08,Dry,20,C,16848,36896,20048
2023-08,Dry,20,E,12400,20304,7904
2023-08,Dry,20,F,7104,4592,-2512
2023-08,Dry,20,G,25568,17328,-8240
2023-08,Dry,40,A,75760,57808,-17952
2023-08,Dry,40,B,117472,171664,54192
2023-08,Dry,40,C,23952,49360,25408
2023-08,Dry,40,D,528,64,-464
2023-08,Dry,40,E,27856,20272,-7584
2023-08,Dry,40,F,17984,12400,-5584
2023-08,Dry,40,G,16576,18496,1920
2023-08,Reefer,20,A,384,64,-320
2023-08,Reefer,20,B,288,224,-64
2023-08,Reefer,20,C,96,64,-32
2023-08,Reefer,20,E,192,32,-160
2023-08,Reefer,20,F,192,0,-192
2023-08,Reefer,20,G,48,16,-32
2023-08,Reefer,40,A,20048,5664,-14384
2023-08,Reefer,40,B,13328,19008,5680
2023-08,Reefer,40,C,7280,21360,14080
2023-08,Reefer,40,D,16,0,-16
2023-08,Reefer,40,E,1104,1424,320
2023-08,Reefer,40,F,2112,864,-1248
2023-08,Reefer,40,G,6048,3088,-2960
2023-09,Dry,20,A,48304,41760,-6544
2023-09,Dry,20,B,119440,116928,-2512
2023-09,Dry,20,C,15904,28128,12224
2023-09,Dry,20,D,0,16,16
2023-09,Dry,20,E,11952,15776,3824
2023-09,Dry,20,F,13424,5760,-7664
2023-09,Dry,20,G,29264,12624,-16640
2023-09,Dry,40,A,74880,53744,-21136
2023-09,Dry,40,B,169552,139648,-29904
2023-09,Dry,40,C,25904,32144,6240
2023-09,Dry,40,D,128,0,-128
2023-09,Dry,40,E,24544,19024,-5520
2023-09,Dry,40,F,24688,14016,-10672
2023-09,Dry,40,G,14672,24464,9792
2023-09,Reefer,20,A,448,32,-416
2023-09,Reefer,20,B,192,176,-16
2023-09,Reefer,20,C,176,16,-160
2023-09,Reefer,20,E,112,80,-32
2023-09,Reefer,20,F,448,64,-384
2023-09,Reefer,20,G,16,0,-16
2023-09,Reefer,40,A,15328,3872,-11456
2023-09,Reefer,40,B,18832,16096,-2736
2023-09,Reefer,40,C,8688,15104,6416
2023-09,Reefer,40,D,240,0,-240
2023-09,Reefer,40,E,880,304,-576
2023-09,Reefer,40,F,4128,720,-3408
2023-09,Reefer,40,G,7200,4016,-3184
2023-10,Dry,20,A,54608,38112,-16496
2023-10,Dry,20,B,123152,134976,11824
2023-10,Dry,20,C,13600,18160,4560
2023-10,Dry,20,D,0,16,16
2023-10,Dry,20,E,14480,19056,4576
2023-10,Dry,20,F,3440,5136,1696
2023-10,Dry,20,G,28304,10576,-17728
2023-10,Dry,40,A,86624,58848,-27776
2023-10,Dry,40,B,104448,131504,27056
2023-10,Dry,40,C,19280,23984,4704
2023-10,Dry,40,D,80,16,-64
2023-10,Dry,40,E,30544,16512,-14032
2023-10,Dry,40,F,13712,12016,-1696
2023-10,Dry,40,G,16576,21680,5104
2023-10,Reefer,20,A,176,0,-176
2023-10,Reefer,20,B,224,240,16
2023-10,Reefer,20,C,160,144,-16
2023-10,Reefer,20,E,288,16,-272
2023-10,Reefer,20,F,128,0,-128
2023-10,Reefer,20,G,32,0,-32
2023-10,Reefer,40,A,14784,10560,-4224
2023-10,Reefer,40,B,15712,16448,736
2023-10,Reefer,40,C,9440,22464,13024
2023-10,Reefer,40,D,0,32,32
2023-10,Reefer,40,E,1104,208,-896
2023-10,Reefer,40,F,1472,432,-1040
2023-10,Reefer,40,G,5696,4560,-1136
2023-11,Dry,20,A,36000,30464,-5536
2023-11,Dry,20,B,127952,118400,-9552
2023-11,Dry,20,C,13472,22976,9504
2023-11,Dry,20,D,0,144,144
2023-11,Dry,20,E,9552,18832,9280
2023-11,Dry,20,F,2784,2416,-368
2023-11,Dry,20,G,21936,13968,-7968
2023-11,Dry,40,A,61632,43776,-17856
2023-11,Dry,40,B,132928,128576,-4352
2023-11,Dry,40,C,18944,35472,16528
2023-11,Dry,40,D,160,16,-144
2023-11,Dry,40,E,19360,17680,-1680
2023-11,Dry,40,F,7488,3296,-4192
2023-11,Dry,40,G,15744,19520,3776
2023-11,Reefer,20,A,304,0,-304
2023-11,Reefer,20,B,240,144,-96
2023-11,Reefer,20,C,112,144,32
2023-11,Reefer,20,E,160,32,-128
2023-11,Reefer,20,F,48,96,48
2023-11,Reefer,20,G,16,80,64
2023-11,Reefer,40,A,18096,7696,-10400
2023-11,Reefer,40,B,16144,14720,-1424
2023-11,Reefer,40,C,4400,13952,9552
2023-11,Reefer,40,D,0,48,48
2023-11,Reefer,40,E,688,560,-128
2023-11,Reefer,40,F,1216,96,-1120
2023-11,Reefer,40,G,5072,6320,1248
2023-12,Dry,20,A,60672,43952,-16720
2023-12,Dry,20,B,133952,114832,-19120
2023-12,Dry,20,C,22672,24208,1536
2023-12,Dry,20,E,13072,19056,5984
2023-12,Dry,20,F,4032,6032,2000
2023-12,Dry,20,G,32960,9648,-23312
2023-12,Dry,40,A,75968,52576,-23392
2023-12,Dry,40,B,149696,135520,-14176
2023-12,Dry,40,C,28768,28496,-272
2023-12,Dry,40,D,1232,160,-1072
2023-12,Dry,40,E,23216,18000,-5216
2023-12,Dry,40,F,9824,16368,6544
2023-12,Dry,40,G,18384,19136,752
2023-12,Reefer,20,A,336,0,-336
2023-12,Reefer,20,B,144,320,176
2023-12,Reefer,20,C,224,64,-160
2023-12,Reefer,20,E,192,32,-160
2023-12,Reefer,20,F,176,48,-128
2023-12,Reefer,20,G,16,16,0
2023-12,Reefer,40,A,14928,5504,-9424
2023-12,Reefer,40,B,20816,21152,336
2023-12,Reefer,40,C,9920,26928,17008
2023-12,Reefer,40,D,0,96,96
2023-12,Reefer,40,E,1600,928,-672
2023-12,Reefer,40,F,624,736,112
2023-12,Reefer,40,G,5136,7264,2128
2023-13,Dry,20,A,60432,34208,-26224
2023-13,Dry,20,B,103888,120704,16816
2023-13,Dry,20,C,16384,21952,5568
2023-13,Dry,20,D,0,80,80
2023-13,Dry,20,E,11648,19392,7744
2023-13,Dry,20,F,2320,5136,2816
2023-13,Dry,20,G,41456,13712,-27744
2023-13,Dry,40,A,94208,48528,-45680
2023-13,Dry,40,B,121136,119280,-1856
2023-13,Dry,40,C,28912,36592,7680
2023-13,Dry,40,D,560,16,-544
2023-13,Dry,40,E,30016,22224,-7792
2023-13,Dry,40,F,6960,5744,-1216
2023-13,Dry,40,G,18320,28704,10384
2023-13,Reefer,20,A,816,32,-784
2023-13,Reefer,20,B,304,272,-32
2023-13,Reefer,20,C,256,176,-80
2023-13,Reefer,20,E,112,96,-16
2023-13,Reefer,20,F,16,0,-16
2023-13,Reefer,20,G,32,48,16
2023-13,Reefer,40,A,22128,6144,-15984
2023-13,Reefer,40,B,24480,23488,-992
2023-13,Reefer,40,C,9648,29472,19824
2023-13,Reefer,40,D,144,64,-80
2023-13,Reefer,40,E,1152,800,-352
2023-13,Reefer,40,F,1024,736,-288
2023-13,Reefer,40,G,6000,9328,3328
2023-14,Dry,20,A,45632,33312,-12320
2023-14,Dry,20,B,131696,135168,3472
2023-14,Dry,20,C,11952,34992,23040
2023-14,Dry,20,D,0,1664,1664
2023-14,Dry,20,E,11440,17552,6112
2023-14,Dry,20,F,8112,9408,1296
2023-14,Dry,20,G,28304,10528,-17776
2023-14,Dry,40,A,77760,48560,-29200
2023-14,Dry,40,B,114560,137424,22864
2023-14,Dry,40,C,19696,39536,19840
2023-14,Dry,40,D,112,0,-112
2023-14,Dry,40,E,23616,14688,-8928
2023-14,Dry,40,F,15632,18064,2432
2023-14,Dry,40,G,17760,21152,3392
2023-14,Reefer,20,A,720,32,-688
2023-14,Reefer,20,B,352,208,-144
2023-14,Reefer,20,C,128,240,112
2023-14,Reefer,20,E,112,16,-96
2023-14,Reefer,20,F,176,128,-48
2023-14,Reefer,20,G,64,208,144
2023-14,Reefer,40,A,14688,10864,-3824
2023-14,Reefer,40,B,15632,18592,2960
2023-14,Reefer,40,C,3968,24240,20272
2023-14,Reefer,40,D,16,32,16
2023-14,Reefer,40,E,1024,496,-528
2023-14,Reefer,40,F,1376,448,-928
2023-14,Reefer,40,G,6080,5248,-832
2023-15,Dry,20,A,44272,46096,1824
2023-15,Dry,20,B,123760,97104,-26656
2023-15,Dry,20,C,15264,36496,21232
2023-15,Dry,20,D,288,0,-288
2023-15,Dry,20,E,7344,27728,20384
2023-15,Dry,20,F,4832,5424,592
2023-15,Dry,20,G,25232,12768,-12464
2023-15,Dry,40,A,65472,51968,-13504
2023-15,Dry,40,B,174080,135232,-38848
2023-15,Dry,40,C,24928,63248,38320
2023-15,Dry,40,E,15184,25792,10608
2023-15,Dry,40,F,11504,16016,4512
2023-15,Dry,40,G,15840,25648,9808
2023-15,Reefer,20,A,528,0,-528
2023-15,Reefer,20,B,128,160,32
2023-15,Reefer,20,C,128,80,-48
2023-15,Reefer,20,E,48,16,-32
2023-15,Reefer,20,F,80,48,-32
2023-15,Reefer,20,G,48,0,-48
2023-15,Reefer,40,A,15744,6736,-9008
2023-15,Reefer,40,B,13776,26848,13072
2023-15,Reefer,40,C,6496,16960,10464
2023-15,Reefer,40,D,0,64,64
2023-15,Reefer,40,E,288,1520,1232
2023-15,Reefer,40,F,720,704,-16
2023-15,Reefer,40,G,3776,6640,2864
2023-16,Dry,20,A,50384,38480,-11904
2023-16,Dry,20,B,102576,131456,28880
2023-16,Dry,20,C,10960,29808,18848
2023-16,Dry,20,D,0,384,384
2023-16,Dry,20,E,14672,26432,11760
2023-16,Dry,20,F,6784,4608,-2176
2023-16,Dry,20,G,27392,16624,-10768
2023-16,Dry,40,A,74672,68320,-6352
2023-16,Dry,40,B,119648,143232,23584
2023-16,Dry,40,C,20400,49216,28816
2023-16,Dry,40,D,80,96,16
2023-16,Dry,40,E,29168,31184,2016
2023-16,Dry,40,F,14432,8928,-5504
2023-16,Dry,40,G,14640,23376,8736
2023-16,Reefer,20,A,512,64,-448
2023-16,Reefer,20,B,240,256,16
2023-16,Reefer,20,C,96,224,128
2023-16,Reefer,20,E,80,32,-48
2023-16,Reefer,20,F,128,48,-80
2023-16,Reefer,20,G,0,80,80
2023-16,Reefer,40,A,18176,5616,-12560
2023-16,Reefer,40,B,23520,16080,-7440
2023-16,Reefer,40,C,4384,26352,21968
2023-16,Reefer,40,D,16,96,80
2023-16,Reefer,40,E,1152,1296,144
2023-16,Reefer,40,F,1600,336,-1264
2023-16,Reefer,40,G,3584,7056,3472
2023-17,Dry,20,A,59520,39008,-20512
2023-17,Dry,20,B,124080,153072,28992
2023-17,Dry,20,C,17072,28528,11456
2023-17,Dry,20,D,0,16,16
2023-17,Dry,20,E,14144,19584,5440
2023-17,Dry,20,F,13184,4912,-8272
2023-17,Dry,20,G,29040,12816,-16224
2023-17,Dry,40,A,92544,54880,-37664
2023-17,Dry,40,B,146752,157680,10928
2023-17,Dry,40,C,30656,48720,18064
2023-17,Dry,40,D,352,48,-304
2023-17,Dry,40,E,31584,27792,-3792
2023-17,Dry,40,F,19568,12864,-6704
2023-17,Dry,40,G,15904,31648,15744
2023-17,Reefer,20,A,736,16,-720
2023-17,Reefer,20,B,272,496,224
2023-17,Reefer,20,C,288,32,-256
2023-17,Reefer,20,E,112,128,16
2023-17,Reefer,20,F,288,0,-288
2023-17,Reefer,20,G,48,64,16
2023-17,Reefer,40,A,18304,8272,-10032
2023-17,Reefer,40,B,21808,16240,-5568
2023-17,Reefer,40,C,7168,15968,8800
2023-17,Reefer,40,D,48,32,-16
2023-17,Reefer,40,E,1024,1680,656
2023-17,Reefer,40,F,1680,1056,-624
2023-17,Reefer,40,G,4256,4608,352
2023-18,Dry,20,A,57840,34128,-23712
2023-18,Dry,20,B,141472,110720,-30752
2023-18,Dry,20,C,12672,30544,17872
2023-18,Dry,20,D,16,16,0
2023-18,Dry,20,E,7248,16752,9504
2023-18,Dry,20,F,5888,6544,656
2023-18,Dry,20,G,28416,12432,-15984
2023-18,Dry,40,A,84800,42768,-42032
2023-18,Dry,40,B,155104,139616,-15488
2023-18,Dry,40,C,24720,55968,31248
2023-18,Dry,40,D,400,16,-384
2023-18,Dry,40,E,17776,26352,8576
2023-18,Dry,40,F,10624,17344,6720
2023-18,Dry,40,G,14368,29120,14752
2023-18,Reefer,20,A,656,16,-640
2023-18,Reefer,20,B,432,160,-272
2023-18,Reefer,20,C,128,128,0
2023-18,Reefer,20,E,48,64,16
2023-18,Reefer,20,F,80,48,-32
2023-18,Reefer,20,G,64,112,48
2023-18,Reefer,40,A,14208,13200,-1008
2023-18,Reefer,40,B,18224,20496,2272
2023-18,Reefer,40,C,5456,24576,19120
2023-18,Reefer,40,D,0,64,64
2023-18,Reefer,40,E,720,1056,336
2023-18,Reefer,40,F,1136,1008,-128
2023-18,Reefer,40,G,2848,2992,144
2023-19,Dry,20,A,55952,35584,-20368
2023-19,Dry,20,B,126544,121728,-4816
2023-19,Dry,20,C,18032,31856,13824
2023-19,Dry,20,D,0,1456,1456
2023-19,Dry,20,E,9520,18816,9296
2023-19,Dry,20,F,7280,6848,-432
2023-19,Dry,20,G,27312,15936,-11376
2023-19,Dry,40,A,79024,53456,-25568
2023-19,Dry,40,B,150560,146288,-4272
2023-19,Dry,40,C,23744,47248,23504
2023-19,Dry,40,D,304,32,-272
2023-19,Dry,40,E,19856,24368,4512
2023-19,Dry,40,F,17312,15968,-1344
2023-19,Dry,40,G,20080,33440,13360
2023-19,Reefer,20,A,480,32,-448
2023-19,Reefer,20,B,304,224,-80
2023-19,Reefer,20,C,208,80,-128
2023-19,Reefer,20,E,80,16,-64
2023-19,Reefer,20,F,112,16,-96
2023-19,Reefer,40,A,16816,6768,-10048
2023-19,Reefer,40,B,18176,15088,-3088
2023-19,Reefer,40,C,6256,12192,5936
2023-19,Reefer,40,D,0,48,48
2023-19,Reefer,40,E,928,1536,608
2023-19,Reefer,40,F,2128,640,-1488
2023-19,Reefer,40,G,3952,2848,-1104
2023-20,Dry,20,A,60592,28896,-31696
2023-20,Dry,20,B,110384,90560,-19824
2023-20,Dry,20,C,17008,29248,12240
2023-20,Dry,20,D,0,5424,5424
2023-20,Dry,20,E,14720,20864,6144
2023-20,Dry,20,F,8048,4624,-3424
2023-20,Dry,20,G,22384,12288,-10096
2023-20,Dry,40,A,87808,51808,-36000
2023-20,Dry,40,B,137328,139296,1968
2023-20,Dry,40,C,25664,56960,31296
2023-20,Dry,40,D,960,48,-912
2023-20,Dry,40,E,31648,30160,-1488
2023-20,Dry,40,F,16512,9856,-6656
2023-20,Dry,40,G,14560,22992,8432
2023-20,Reefer,20,A,288,64,-224
2023-20,Reefer,20,B,80,224,144
2023-20,Reefer,20,C,208,128,-80
2023-20,Reefer,20,E,128,48,-80
2023-20,Reefer,20,F,224,0,-224
2023-20,Reefer,20,G,112,16,-96
2023-20,Reefer,40,A,18288,10224,-8064
2023-20,Reefer,40,B,12368,15072,2704
2023-20,Reefer,40,C,6208,21328,15120
2023-20,Reefer,40,D,0,64,64
2023-20,Reefer,40,E,1408,1264,-144
2023-20,Reefer,40,F,2416,720,-1696
2023-20,Reefer,40,G,5568,1696,-3872
2023-21,Dry,20,A,52224,42128,-10096
2023-21,Dry,20,B,100240,138384,38144
2023-21,Dry,20,C,12672,31104,18432
2023-21,Dry,20,D,16,112,96
2023-21,Dry,20,E,11264,19072,7808
2023-21,Dry,20,F,4896,5744,848
2023-21,Dry,20,G,37600,9712,-27888
2023-21,Dry,40,A,71552,61536,-10016
2023-21,Dry,40,B,147344,166480,19136
2023-21,Dry,40,C,19184,48592,29408
2023-21,Dry,40,D,1792,80,-1712
2023-21,Dry,40,E,24048,27808,3760
2023-21,Dry,40,F,12848,16128,3280
2023-21,Dry,40,G,18704,21536,2832
2023-21,Reefer,20,A,352,48,-304
2023-21,Reefer,20,B,288,176,-112
2023-21,Reefer,20,C,160,64,-96
2023-21,Reefer,20,E,96,64,-32
2023-21,Reefer,20,F,192,16,-176
2023-21,Reefer,20,G,64,16,-48
2023-21,Reefer,40,A,12096,8928,-3168
2023-21,Reefer,40,B,21504,19904,-1600
2023-21,Reefer,40,C,4128,19936,15808
2023-21,Reefer,40,D,0,48,48
2023-21,Reefer,40,E,816,1600,784
2023-21,Reefer,40,F,2128,640,-1488
2023-21,Reefer,40,G,4272,2384,-1888
2023-22,Dry,20,A,38608,31808,-6800
2023-22,Dry,20,B,129520,141600,12080
2023-22,Dry,20,C,15712,20768,5056
2023-22,Dry,20,D,128,3824,3696
2023-22,Dry,20,E,9744,18160,8416
2023-22,Dry,20,F,8064,4528,-3536
2023-22,Dry,20,G,32096,8656,-23440
2023-22,Dry,40,A,73056,43712,-29344
2023-22,Dry,40,B,168384,148496,-19888
2023-22,Dry,40,C,23824,38480,14656
2023-22,Dry,40,D,288,64,-224
2023-22,Dry,40,E,16944,34672,17728
2023-22,Dry,40,F,18352,10112,-8240
2023-22,Dry,40,G,21168,23552,2384
2023-22,Reefer,20,A,448,48,-400
2023-22,Reefer,20,B,96,144,48
2023-22,Reefer,20,C,192,64,-128
2023-22,Reefer,20,E,112,64,-48
2023-22,Reefer,20,F,192,16,-176
2023-22,Reefer,20,G,16,0,-16
2023-22,Reefer,40,A,13840,9104,-4736
2023-22,Reefer,40,B,18656,19936,1280
2023-22,Reefer,40,C,4576,21488,16912
2023-22,Reefer,40,E,784,1072,288
2023-22,Reefer,40,F,2416,832,-1584
2023-22,Reefer,40,G,5520,2080,-3440
2023-23,Dry,20,A,60624,45504,-15120
2023-23,Dry,20,B,140064,102640,-37424
2023-23,Dry,20,C,13632,28032,14400
2023-23,Dry,20,E,11696,18784,7088
2023-23,Dry,20,F,7008,5504,-1504
2023-23,Dry,20,G,25920,10416,-15504
2023-23,Dry,40,A,79840,70928,-8912
2023-23,Dry,40,B,165728,158752,-6976
2023-23,Dry,40,C,19408,53008,33600
2023-23,Dry,40,D,352,0,-352
2023-23,Dry,40,E,29904,23840,-6064
2023-23,Dry,40,F,18944,17472,-1472
2023-23,Dry,40,G,20160,27392,7232
2023-23,Reefer,20,A,608,0,-608
2023-23,Reefer,20,B,288,192,-96
2023-23,Reefer,20,C,144,48,-96
2023-23,Reefer,20,E,16,64,48
2023-23,Reefer,20,F,112,16,-96
2023-23,Reefer,20,G,48,128,80
2023-23,Reefer,40,A,16016,5360,-10656
2023-23,Reefer,40,B,21072,17504,-3568
2023-23,Reefer,40,C,3568,23376,19808
2023-23,Reefer,40,E,1232,1552,320
2023-23,Reefer,40,F,2816,1120,-1696
2023-23,Reefer,40,G,5152,1760,-3392
2023-24,Dry,20,A,54112,40944,-13168
2023-24,Dry,20,B,126288,120864,-5424
2023-24,Dry,20,C,15936,20464,4528
2023-24,Dry,20,D,0,2400,2400
2023-24,Dry,20,E,9712,13760,4048
2023-24,Dry,20,F,6880,4320,-2560
2023-24,Dry,20,G,28912,6528,-22384
2023-24,Dry,40,A,75568,51536,-24032
2023-24,Dry,40,B,148880,139376,-9504
2023-24,Dry,40,C,24608,41616,17008
2023-24,Dry,40,D,464,16,-448
2023-24,Dry,40,E,20128,16960,-3168
2023-24,Dry,40,F,19472,14096,-5376
2023-24,Dry,40,G,14912,24032,9120
2023-24,Reefer,20,A,416,0,-416
2023-24,Reefer,20,B,368,448,80
2023-24,Reefer,20,C,192,64,-128
2023-24,Reefer,20,E,144,0,-144
2023-24,Reefer,20,F,320,32,-288
2023-24,Reefer,20,G,64,0,-64
2023-24,Reefer,40,A,16464,4432,-12032
2023-24,Reefer,40,B,15872,19792,3920
2023-24,Reefer,40,C,6032,17472,11440
2023-24,Reefer,40,E,832,400,-432
2023-24,Reefer,40,F,2976,832,-2144
2023-24,Reefer,40,G,4048,3024,-1024
2023-25,Dry,20,A,61328,28800,-32528
2023-25,Dry,20,B,94592,96448,1856
2023-25,Dry,20,C,18592,28880,10288
2023-25,Dry,20,D,0,6896,6896
2023-25,Dry,20,E,13936,14752,816
2023-25,Dry,20,F,8048,4560,-3488
2023-25,Dry,20,G,32816,9776,-23040
2023-25,Dry,40,A,87824,53280,-34544
2023-25,Dry,40,B,159792,122736,-37056
2023-25,Dry,40,C,25104,48832,23728
2023-25,Dry,40,D,1312,32,-1280
2023-25,Dry,40,E,24560,23920,-640
2023-25,Dry,40,F,22496,7184,-15312
2023-25,Dry,40,G,21104,25840,4736
2023-25,Reefer,20,A,608,32,-576
2023-25,Reefer,20,B,144,224,80
2023-25,Reefer,20,C,144,208,64
2023-25,Reefer,20,E,160,192,32
2023-25,Reefer,20,F,192,16,-176
2023-25,Reefer,20,G,144,64,-80
2023-25,Reefer,40,A,15600,8592,-7008
2023-25,Reefer,40,B,14800,12560,-2240
2023-25,Reefer,40,C,5744,28080,22336
2023-25,Reefer,40,E,800,1248,448
2023-25,Reefer,40,F,3696,608,-3088
2023-25,Reefer,40,G,4336,2272,-2064
2023-26,Dry,20,A,68112,31888,-36224
2023-26,Dry,20,B,103920,67936,-35984
2023-26,Dry,20,C,14608,23104,8496
2023-26,Dry,20,D,432,176,-256
2023-26,Dry,20,E,13680,18272,4592
2023-26,Dry,20,F,7696,5984,-1712
2023-26,Dry,20,G,33008,12304,-20704
2023-26,Dry,40,A,84640,51760,-32880
2023-26,Dry,40,B,126032,109072,-16960
2023-26,Dry,40,C,23232,52400,29168
2023-26,Dry,40,D,400,64,-336
2023-26,Dry,40,E,22384,26784,4400
2023-26,Dry,40,F,19248,17776,-1472
2023-26,Dry,40,G,21824,22224,400
2023-26,Reefer,20,A,528,16,-512
2023-26,Reefer,20,B,304,96,-208
2023-26,Reefer,20,C,192,80,-112
2023-26,Reefer,20,E,48,32,-16
2023-26,Reefer,20,F,272,112,-160
2023-26,Reefer,20,G,16,32,16
2023-26,Reefer,40,A,12336,5072,-7264
2023-26,Reefer,40,B,11408,8304,-3104
2023-26,Reefer,40,C,4640,20784,16144
2023-26,Reefer,40,D,32,0,-32
2023-26,Reefer,40,E,944,1136,192
2023-26,Reefer,40,F,3152,912,-2240
2023-26,Reefer,40,G,6592,1056,-5536
2023-27,Dry,20,A,57632,26576,-31056
2023-27,Dry,20,B,101072,121392,20320
2023-27,Dry,20,C,15264,14848,-416
2023-27,Dry,20,D,0,6016,6016
2023-27,Dry,20,E,9104,11216,2112
2023-27,Dry,20,F,7360,5328,-2032
2023-27,Dry,20,G,24512,5664,-18848
2023-27,Dry,40,A,81872,49952,-31920
2023-27,Dry,40,B,145344,155056,9712
2023-27,Dry,40,C,22256,37232,14976
2023-27,Dry,40,D,1296,80,-1216
2023-27,Dry,40,E,30240,19936,-10304
2023-27,Dry,40,F,19568,15504,-4064
2023-27,Dry,40,G,16720,15088,-1632
2023-27,Reefer,20,A,576,32,-544
2023-27,Reefer,20,B,208,256,48
2023-27,Reefer,20,C,80,80,0
2023-27,Reefer,20,E,96,112,16
2023-27,Reefer,20,F,336,16,-320
2023-27,Reefer,20,G,16,0,-16
2023-27,Reefer,40,A,14368,3952,-10416
2023-27,Reefer,40,B,9760,16016,6256
2023-27,Reefer,40,C,3808,12816,9008
2023-27,Reefer,40,D,32,0,-32
2023-27,Reefer,40,E,1232,1056,-176
2023-27,Reefer,40,F,3536,944,-2592
2023-27,Reefer,40,G,3776,1392,-2384
2023-28,Dry,20,A,57056,24976,-32080
2023-28,Dry,20,B,115456,102960,-12496
2023-28,Dry,20,C,15392,15856,464
2023-28,Dry,20,E,15712,11168,-4544
2023-28,Dry,20,F,6784,4176,-2608
2023-28,Dry,20,G,29216,14128,-15088
2023-28,Dry,40,A,72480,39040,-33440
2023-28,Dry,40,B,158064,138000,-20064
2023-28,Dry,40,C,20384,28304,7920
2023-28,Dry,40,D,32,16,-16
2023-28,Dry,40,E,23392,19024,-4368
2023-28,Dry,40,F,17712,7472,-10240
2023-28,Dry,40,G,16448,30704,14256
2023-28,Reefer,20,A,560,0,-560
2023-28,Reefer,20,B,320,464,144
2023-28,Reefer,20,C,80,16,-64
2023-28,Reefer,20,E,128,128,0
2023-28,Reefer,20,F,192,32,-160
2023-28,Reefer,20,G,16,32,16
2023-28,Reefer,40,A,15296,4928,-10368
2023-28,Reefer,40,B,17584,12768,-4816
2023-28,Reefer,40,C,2976,17712,14736
2023-28,Reefer,40,D,0,16,16
2023-28,Reefer,40,E,976,1600,624
2023-28,Reefer,40,F,3168,912,-2256
2023-28,Reefer,40,G,4928,1952,-2976
2023-29,Dry,20,A,50176,32944,-17232
2023-29,Dry,20,B,102560,129328,26768
2023-29,Dry,20,C,10656,24848,14192
2023-29,Dry,20,D,0,6672,6672
2023-29,Dry,20,E,9376,12576,3200
2023-29,Dry,20,F,6176,4416,-1760
2023-29,Dry,20,G,25056,12080,-12976
2023-29,Dry,40,A,68784,72848,4064
2023-29,Dry,40,B,142384,155424,13040
2023-29,Dry,40,C,19312,45808,26496
2023-29,Dry,40,D,1936,112,-1824
2023-29,Dry,40,E,22368,19648,-2720
2023-29,Dry,40,F,16112,16896,784
2023-29,Dry,40,G,16016,25024,9008
2023-29,Reefer,20,A,512,32,-480
2023-29,Reefer,20,B,448,384,-64
2023-29,Reefer,20,C,112,112,0
2023-29,Reefer,20,E,112,112,0
2023-29,Reefer,20,F,352,0,-352
2023-29,Reefer,20,G,32,144,112
2023-29,Reefer,40,A,14688,3360,-11328
2023-29,Reefer,40,B,11888,12192,304
2023-29,Reefer,40,C,5056,6128,1072
2023-29,Reefer,40,D,32,0,-32
2023-29,Reefer,40,E,864,1344,480
2023-29,Reefer,40,F,3056,896,-2160
2023-29,Reefer,40,G,3568,992,-2576
2023-30,Dry,20,A,59776,27488,-32288
2023-30,Dry,20,B,125792,116080,-9712
2023-30,Dry,20,C,18416,24112,5696
2023-30,Dry,20,D,0,544,544
2023-30,Dry,20,E,25328,17328,-8000
2023-30,Dry,20,F,6928,6144,-784
2023-30,Dry,20,G,27120,8336,-18784
2023-30,Dry,40,A,68784,45232,-23552
2023-30,Dry,40,B,153728,134352,-19376
2023-30,Dry,40,C,24256,43328,19072
2023-30,Dry,40,D,144,0,-144
2023-30,Dry,40,E,33952,25104,-8848
2023-30,Dry,40,F,19408,15824,-3584
2023-30,Dry,40,G,12272,23216,10944
2023-30,Reefer,20,A,272,32,-240
2023-30,Reefer,20,B,240,272,32
2023-30,Reefer,20,C,272,192,-80
2023-30,Reefer,20,E,256,48,-208
2023-30,Reefer,20,F,240,0,-240
2023-30,Reefer,20,G,64,0,-64
2023-30,Reefer,40,A,12496,6416,-6080
2023-30,Reefer,40,B,8736,11136,2400
2023-30,Reefer,40,C,5440,17040,11600
2023-30,Reefer,40,D,32,0,-32
2023-30,Reefer,40,E,1312,1136,-176
2023-30,Reefer,40,F,4208,576,-3632
2023-30,Reefer,40,G,3920,1344,-2576
2023-31,Dry,20,A,47680,21920,-25760
2023-31,Dry,20,B,90960,113280,22320
2023-31,Dry,20,C,13200,21984,8784
2023-31,Dry,20,D,112,0,-112
2023-31,Dry,20,E,12320,15504,3184
2023-31,Dry,20,F,6752,6320,-432
2023-31,Dry,20,G,37264,10480,-26784
2023-31,Dry,40,A,68896,48064,-20832
2023-31,Dry,40,B,119360,141552,22192
2023-31,Dry,40,C,19776,39584,19808
2023-31,Dry,40,D,1568,0,-1568
2023-31,Dry,40,E,22352,22736,384
2023-31,Dry,40,F,15648,16400,752
2023-31,Dry,40,G,17392,23472,6080
2023-31,Reefer,20,A,512,48,-464
2023-31,Reefer,20,B,352,592,240
2023-31,Reefer,20,C,192,64,-128
2023-31,Reefer,20,E,192,96,-96
2023-31,Reefer,20,F,400,0,-400
2023-31,Reefer,20,G,16,96,80
2023-31,Reefer,40,A,12064,3856,-8208
2023-31,Reefer,40,B,13392,13552,160
2023-31,Reefer,40,C,5136,24000,18864
2023-31,Reefer,40,E,1008,1008,0
2023-31,Reefer,40,F,3040,480,-2560
2023-31,Reefer,40,G,4608,1344,-3264
2023-32,Dry,20,A,56032,31744,-24288
2023-32,Dry,20,B,110064,103664,-6400
2023-32,Dry,20,C,13072,24112,11040
2023-32,Dry,20,D,0,5728,5728
2023-32,Dry,20,E,12352,15440,3088
2023-32,Dry,20,F,7280,3184,-4096
2023-32,Dry,20,G,21680,7632,-14048
2023-32,Dry,40,A,75824,49600,-26224
2023-32,Dry,40,B,129520,134304,4784
2023-32,Dry,40,C,23920,43200,19280
2023-32,Dry,40,D,576,64,-512
2023-32,Dry,40,E,24752,19968,-4784
2023-32,Dry,40,F,14848,7744,-7104
2023-32,Dry,40,G,14928,18016,3088
2023-32,Reefer,20,A,512,32,-480
2023-32,Reefer,20,B,704,448,-256
2023-32,Reefer,20,C,336,160,-176
2023-32,Reefer,20,E,144,144,0
2023-32,Reefer,20,F,272,16,-256
2023-32,Reefer,20,G,32,64,32
2023-32,Reefer,40,A,14992,3584,-11408
2023-32,Reefer,40,B,16400,16640,240
2023-32,Reefer,40,C,5632,19952,14320
2023-32,Reefer,40,E,944,1344,400
2023-32,Reefer,40,F,2768,656,-2112
2023-32,Reefer,40,G,3808,1136,-2672
2023-33,Dry,20,A,40080,34496,-5584
2023-33,Dry,20,B,156976,132576,-24400
2023-33,Dry,20,C,11952,30912,18960
2023-33,Dry,20,D,160,1664,1504
2023-33,Dry,20,E,15824,19168,3344
2023-33,Dry,20,F,6320,6096,-224
2023-33,Dry,20,G,22800,9712,-13088
2023-33,Dry,40,A,55376,63968,8592
2023-33,Dry,40,B,161344,135888,-25456
2023-33,Dry,40,C,15216,36448,21232
2023-33,Dry,40,D,1008,96,-912
2023-33,Dry,40,E,25360,21904,-3456
2023-33,Dry,40,F,12032,14288,2256
2023-33,Dry,40,G,12624,21920,9296
2023-33,Reefer,20,A,480,16,-464
2023-33,Reefer,20,B,544,288,-256
2023-33,Reefer,20,C,112,192,80
2023-33,Reefer,20,E,144,64,-80
2023-33,Reefer,20,F,160,48,-112
2023-33,Reefer,20,G,16,0,-16
2023-33,Reefer,40,A,11360,3280,-8080
2023-33,Reefer,40,B,13744,12640,-1104
2023-33,Reefer,40,C,3264,14256,10992
2023-33,Reefer,40,D,32,0,-32
2023-33,Reefer,40,E,912,992,80
2023-33,Reefer,40,F,2656,688,-1968
2023-33,Reefer,40,G,4080,1152,-2928
2023-34,Dry,20,A,48160,44448,-3712
2023-34,Dry,20,B,95936,93312,-2624
2023-34,Dry,20,C,15872,23088,7216
2023-34,Dry,20,D,0,4048,4048
2023-34,Dry,20,E,12960,11552,-1408
2023-34,Dry,20,F,4320,4176,-144
2023-34,Dry,20,G,19440,10048,-9392
2023-34,Dry,40,A,71808,70032,-1776
2023-34,Dry,40,B,134000,119152,-14848
2023-34,Dry,40,C,24336,35504,11168
2023-34,Dry,40,D,336,160,-176
2023-34,Dry,40,E,24928,17392,-7536
2023-34,Dry,40,F,9728,15168,5440
2023-34,Dry,40,G,9472,19168,9696
2023-34,Reefer,20,A,640,48,-592
2023-34,Reefer,20,B,128,144,16
2023-34,Reefer,20,C,144,208,64
2023-34,Reefer,20,E,80,64,-16
2023-34,Reefer,20,F,192,16,-176
2023-34,Reefer,20,G,32,96,64
2023-34,Reefer,40,A,13472,4144,-9328
2023-34,Reefer,40,B,14320,12880,-1440
2023-34,Reefer,40,C,6176,17184,11008
2023-34,Reefer,40,E,1088,816,-272
2023-34,Reefer,40,F,2320,416,-1904
2023-34,Reefer,40,G,3840,1040,-2800
2023-35,Dry,20,A,46000,31648,-14352
2023-35,Dry,20,B,106640,113680,7040
2023-35,Dry,20,C,13376,26320,12944
2023-35,Dry,20,D,160,2704,2544
2023-35,Dry,20,E,10880,14048,3168
2023-35,Dry,20,F,6768,6320,-448
2023-35,Dry,20,G,23520,9616,-13904
2023-35,Dry,40,A,63664,65824,2160
2023-35,Dry,40,B,131296,138048,6752
2023-35,Dry,40,C,23440,45952,22512
2023-35,Dry,40,D,1104,144,-960
2023-35,Dry,40,E,18928,14768,-4160
2023-35,Dry,40,F,17232,20240,3008
2023-35,Dry,40,G,13008,20096,7088
2023-35,Reefer,20,A,352,48,-304
2023-35,Reefer,20,B,304,384,80
2023-35,Reefer,20,C,256,80,-176
2023-35,Reefer,20,E,16,64,48
2023-35,Reefer,20,F,224,0,-224
2023-35,Reefer,20,G,16,32,16
2023-35,Reefer,40,A,9776,3456,-6320
2023-35,Reefer,40,B,14624,12976,-1648
2023-35,Reefer,40,C,4096,24096,20000
2023-35,Reefer,40,D,16,16,0
2023-35,Reefer,40,E,896,848,-48
2023-35,Reefer,40,F,3344,624,-2720
2023-35,Reefer,40,G,4512,976,-3536
2023-36,Dry,20,A,47584,22624,-24960
2023-36,Dry,20,B,105872,97280,-8592
2023-36,Dry,20,C,10144,18304,8160
2023-36,Dry,20,D,672,1872,1200
2023-36,Dry,20,E,20048,21104,1056
2023-36,Dry,20,F,6192,5184,-1008
2023-36,Dry,20,G,25584,10752,-14832
2023-36,Dry,40,A,70192,46784,-23408
2023-36,Dry,40,B,111296,106528,-4768
2023-36,Dry,40,C,15664,27632,11968
2023-36,Dry,40,D,1008,96,-912
2023-36,Dry,40,E,30592,25744,-4848
2023-36,Dry,40,F,14624,10880,-3744
2023-36,Dry,40,G,13824,14624,800
2023-36,Reefer,20,A,464,64,-400
2023-36,Reefer,20,B,416,432,16
2023-36,Reefer,20,C,192,32,-160
2023-36,Reefer,20,E,160,64,-96
2023-36,Reefer,20,F,256,48,-208
2023-36,Reefer,20,G,0,16,16
2023-36,Reefer,40,A,14688,3920,-10768
2023-36,Reefer,40,B,11616,13792,2176
2023-36,Reefer,40,C,3808,6960,3152
2023-36,Reefer,40,D,32,0,-32
2023-36,Reefer,40,E,1392,1152,-240
2023-36,Reefer,40,F,3280,560,-2720
2023-36,Reefer,40,G,3648,1440,-2208
2023-37,Dry,20,A,49728,30064,-19664
2023-37,Dry,20,B,79072,93600,14528
2023-37,Dry,20,C,15296,25648,10352
2023-37,Dry,20,E,16528,16224,-304
2023-37,Dry,20,F,4768,2464,-2304
2023-37,Dry,20,G,27408,11712,-15696
2023-37,Dry,40,A,71568,49888,-21680
2023-37,Dry,40,B,110176,123920,13744
2023-37,Dry,40,C,18576,36448,17872
2023-37,Dry,40,E,22800,21088,-1712
2023-37,Dry,40,F,12080,7392,-4688
2023-37,Dry,40,G,19504,28864,9360
2023-37,Reefer,20,A,448,16,-432
2023-37,Reefer,20,B,336,256,-80
2023-37,Reefer,20,C,208,176,-32
2023-37,Reefer,20,E,48,112,64
2023-37,Reefer,20,F,224,0,-224
2023-37,Reefer,20,G,48,0,-48
2023-37,Reefer,40,A,14624,2672,-11952
2023-37,Reefer,40,B,13584,13072,-512
2023-37,Reefer,40,C,4912,6000,1088
2023-37,Reefer,40,E,1184,656,-528
2023-37,Reefer,40,F,1936,368,-1568
2023-37,Reefer,40,G,6896,1360,-5536
2023-38,Dry,20,A,50160,22048,-28112
2023-38,Dry,20,B,100400,90112,-10288
2023-38,Dry,20,C,16784,25488,8704
2023-38,Dry,20,D,592,2896,2304
2023-38,Dry,20,E,11040,15200,4160
2023-38,Dry,20,F,6752,7200,448
2023-38,Dry,20,G,21280,11008,-10272
2023-38,Dry,40,A,70736,39632,-31104
2023-38,Dry,40,B,124576,142224,17648
2023-38,Dry,40,C,21584,35440,13856
2023-38,Dry,40,D,1328,6880,5552
2023-38,Dry,40,E,24672,17232,-7440
2023-38,Dry,40,F,20848,19632,-1216
2023-38,Dry,40,G,14192,24160,9968
2023-38,Reefer,20,A,640,16,-624
2023-38,Reefer,20,B,128,544,416
2023-38,Reefer,20,C,240,48,-192
2023-38,Reefer,20,E,32,64,32
2023-38,Reefer,20,F,240,0,-240
2023-38,Reefer,20,G,32,48,16
2023-38,Reefer,40,A,15664,2224,-13440
2023-38,Reefer,40,B,12416,13136,720
2023-38,Reefer,40,C,5776,33264,27488
2023-38,Reefer,40,D,0,608,608
2023-38,Reefer,40,E,1248,672,-576
2023-38,Reefer,40,F,3392,656,-2736
2023-38,Reefer,40,G,6352,976,-5376
2023-39,Dry,20,A,46592,26096,-20496
2023-39,Dry,20,B,95024,89376,-5648
2023-39,Dry,20,C,15920,24240,8320
2023-39,Dry,20,D,160,112,-48
2023-39,Dry,20,E,16448,13680,-2768
2023-39,Dry,20,F,5984,5024,-960
2023-39,Dry,20,G,24400,10944,-13456
2023-39,Dry,40,A,73296,45600,-27696
2023-39,Dry,40,B,145152,136112,-9040
2023-39,Dry,40,C,23088,33024,9936
2023-39,Dry,40,D,464,240,-224
2023-39,Dry,40,E,22656,16560,-6096
2023-39,Dry,40,F,12592,11936,-656
2023-39,Dry,40,G,15840,24576,8736
2023-39,Reefer,20,A,528,64,-464
2023-39,Reefer,20,B,656,288,-368
2023-39,Reefer,20,C,112,112,0
2023-39,Reefer,20,E,80,80,0
2023-39,Reefer,20,F,176,32,-144
2023-39,Reefer,20,G,80,48,-32
2023-39,Reefer,40,A,12736,4320,-8416
2023-39,Reefer,40,B,15888,17296,1408
2023-39,Reefer,40,C,5568,20208,14640
2023-39,Reefer,40,E,1168,432,-736
2023-39,Reefer,40,F,2320,448,-1872
2023-39,Reefer,40,G,5376,720,-4656
2023-40,Dry,20,A,49488,27424,-22064
2023-40,Dry,20,B,95824,101728,5904
2023-40,Dry,20,C,17312,31088,13776
2023-40,Dry,20,E,13920,18272,4352
2023-40,Dry,20,F,8704,3952,-4752
2023-40,Dry,20,G,27968,8576,-19392
2023-40,Dry,40,A,70816,54688,-16128
2023-40,Dry,40,B,161376,144896,-16480
2023-40,Dry,40,C,22576,41952,19376
2023-40,Dry,40,D,688,0,-688
2023-40,Dry,40,E,24016,24320,304
2023-40,Dry,40,F,18768,11072,-7696
2023-40,Dry,40,G,16992,20688,3696
2023-40,Reefer,20,A,448,0,-448
2023-40,Reefer,20,B,368,320,-48
2023-40,Reefer,20,C,176,96,-80
2023-40,Reefer,20,E,176,96,-80
2023-40,Reefer,20,F,272,16,-256
2023-40,Reefer,20,G,64,0,-64
2023-40,Reefer,40,A,12512,4224,-8288
2023-40,Reefer,40,B,17360,14064,-3296
2023-40,Reefer,40,C,6496,26144,19648
2023-40,Reefer,40,D,32,0,-32
2023-40,Reefer,40,E,1200,1216,16
2023-40,Reefer,40,F,4080,896,-3184
2023-40,Reefer,40,G,4576,912,-3664
2023-41,Dry,20,A,48880,29104,-19776
2023-41,Dry,20,B,91200,99296,8096
2023-41,Dry,20,C,13792,35136,21344
2023-41,Dry,20,D,0,4864,4864
2023-41,Dry,20,E,14528,17776,3248
2023-41,Dry,20,F,7920,5056,-2864
2023-41,Dry,20,G,21088,8128,-12960
2023-41,Dry,40,A,66944,50928,-16016
2023-41,Dry,40,B,104544,141904,37360
2023-41,Dry,40,C,18064,31616,13552
2023-41,Dry,40,D,560,256,-304
2023-41,Dry,40,E,25024,18736,-6288
2023-41,Dry,40,F,16048,16800,752
2023-41,Dry,40,G,15360,19936,4576
2023-41,Reefer,20,A,800,0,-800
2023-41,Reefer,20,B,352,336,-16
2023-41,Reefer,20,C,128,352,224
2023-41,Reefer,20,E,64,32,-32
2023-41,Reefer,20,F,208,16,-192
2023-41,Reefer,20,G,48,32,-16
2023-41,Reefer,40,A,16128,4432,-11696
2023-41,Reefer,40,B,15088,15088,0
2023-41,Reefer,40,C,5872,20656,14784
2023-41,Reefer,40,D,0,32,32
2023-41,Reefer,40,E,1280,944,-336
2023-41,Reefer,40,F,3248,752,-2496
2023-41,Reefer,40,G,5856,2864,-2992
2023-42,Dry,20,A,63152,29232,-33920
2023-42,Dry,20,B,101312,75808,-25504
2023-42,Dry,20,C,21488,18192,-3296
2023-42,Dry,20,D,16,64,48
2023-42,Dry,20,E,21072,15776,-5296
2023-42,Dry,20,F,7600,6672,-928
2023-42,Dry,20,G,26336,5856,-20480
2023-42,Dry,40,A,79824,56272,-23552
2023-42,Dry,40,B,190688,125392,-65296
2023-42,Dry,40,C,27328,34016,6688
2023-42,Dry,40,D,656,320,-336
2023-42,Dry,40,E,28720,19520,-9200
2023-42,Dry,40,F,20464,13696,-6768
2023-42,Dry,40,G,16544,16864,320
2023-42,Reefer,20,A,464,32,-432
2023-42,Reefer,20,B,288,272,-16
2023-42,Reefer,20,C,192,128,-64
2023-42,Reefer,20,E,96,96,0
2023-42,Reefer,20,F,224,16,-208
2023-42,Reefer,20,G,0,144,144
2023-42,Reefer,40,A,16176,1792,-14384
2023-42,Reefer,40,B,17936,16608,-1328
2023-42,Reefer,40,C,7904,9056,1152
2023-42,Reefer,40,E,1312,496,-816
2023-42,Reefer,40,F,5120,480,-4640
2023-42,Reefer,40,G,6272,736,-5536
2023-43,Dry,20,A,53808,18912,-34896
2023-43,Dry,20,B,90560,124688,34128
2023-43,Dry,20,C,19664,20016,352
2023-43,Dry,20,D,0,1056,1056
2023-43,Dry,20,E,21248,13696,-7552
2023-43,Dry,20,F,8672,4704,-3968
2023-43,Dry,20,G,30976,9568,-21408
2023-43,Dry,40,A,61344,32800,-28544
2023-43,Dry,40,B,114912,149776,34864
2023-43,Dry,40,C,23536,30592,7056
2023-43,Dry,40,D,2208,64,-2144
2023-43,Dry,40,E,33408,16240,-17168
2023-43,Dry,40,F,12544,12448,-96
2023-43,Dry,40,G,22368,24544,2176
2023-43,Reefer,20,A,576,64,-512
2023-43,Reefer,20,B,304,320,16
2023-43,Reefer,20,C,240,32,-208
2023-43,Reefer,20,E,96,96,0
2023-43,Reefer,20,F,192,16,-176
2023-43,Reefer,20,G,48,0,-48
2023-43,Reefer,40,A,13840,3840,-10000
2023-43,Reefer,40,B,15936,16896,960
2023-43,Reefer,40,C,9968,5552,-4416
2023-43,Reefer,40,D,16,16,0
2023-43,Reefer,40,E,1568,608,-960
2023-43,Reefer,40,F,2720,288,-2432
2023-43,Reefer,40,G,8624,3248,-5376
2023-44,Dry,20,A,39456,14944,-24512
2023-44,Dry,20,B,99120,92304,-6816
2023-44,Dry,20,C,13504,16192,2688
2023-44,Dry,20,D,320,48,-272
2023-44,Dry,20,E,9056,13008,3952
2023-44,Dry,20,F,4928,2096,-2832
2023-44,Dry,20,G,20528,5536,-14992
2023-44,Dry,40,A,52720,25104,-27616
2023-44,Dry,40,B,113328,160560,47232
2023-44,Dry,40,C,17216,22576,5360
2023-44,Dry,40,D,1792,0,-1792
2023-44,Dry,40,E,16064,16960,896
2023-44,Dry,40,F,12240,2928,-9312
2023-44,Dry,40,G,13600,16896,3296
2023-44,Reefer,20,A,304,0,-304
2023-44,Reefer,20,B,352,416,64
2023-44,Reefer,20,C,112,48,-64
2023-44,Reefer,20,E,224,64,-160
2023-44,Reefer,20,F,176,0,-176
2023-44,Reefer,20,G,80,32,-48
2023-44,Reefer,40,A,10928,4368,-6560
2023-44,Reefer,40,B,15488,17248,1760
2023-44,Reefer,40,C,8256,14496,6240
2023-44,Reefer,40,E,1152,576,-576
2023-44,Reefer,40,F,2368,304,-2064
2023-44,Reefer,40,G,3504,2080,-1424
2023-45,Dry,20,A,42400,28992,-13408
2023-45,Dry,20,B,84736,79376,-5360
2023-45,Dry,20,C,9360,30480,21120
2023-45,Dry,20,D,0,2400,2400
2023-45,Dry,20,E,15632,10160,-5472
2023-45,Dry,20,F,8352,5376,-2976
2023-45,Dry,20,G,29216,7872,-21344
2023-45,Dry,40,A,54880,63952,9072
2023-45,Dry,40,B,144080,104608,-39472
2023-45,Dry,40,C,13264,39472,26208
2023-45,Dry,40,D,288,0,-288
2023-45,Dry,40,E,21248,5408,-15840
2023-45,Dry,40,F,14288,15360,1072
2023-45,Dry,40,G,17648,14000,-3648
2023-45,Reefer,20,A,256,64,-192
2023-45,Reefer,20,B,448,304,-144
2023-45,Reefer,20,C,80,64,-16
2023-45,Reefer,20,E,96,0,-96
2023-45,Reefer,20,F,240,0,-240
2023-45,Reefer,20,G,48,48,0
2023-45,Reefer,40,A,14416,4224,-10192
2023-45,Reefer,40,B,14944,12128,-2816
2023-45,Reefer,40,C,10048,4320,-5728
2023-45,Reefer,40,D,16,0,-16
2023-45,Reefer,40,E,1632,816,-816
2023-45,Reefer,40,F,3200,752,-2448
2023-45,Reefer,40,G,7120,2144,-4976
2023-46,Dry,20,A,75808,32256,-43552
2023-46,Dry,20,B,84976,79456,-5520
2023-46,Dry,20,C,19328,27280,7952
2023-46,Dry,20,D,48,3120,3072
2023-46,Dry,20,E,16576,16608,32
2023-46,Dry,20,F,5728,4176,-1552
2023-46,Dry,20,G,32464,5520,-26944
2023-46,Dry,40,A,81360,48928,-32432
2023-46,Dry,40,B,119568,107376,-12192
2023-46,Dry,40,C,26352,37472,11120
2023-46,Dry,40,D,432,224,-208
2023-46,Dry,40,E,25968,21552,-4416
2023-46,Dry,40,F,12832,8896,-3936
2023-46,Dry,40,G,19712,19728,16
2023-46,Reefer,20,A,1008,32,-976
2023-46,Reefer,20,B,160,224,64
2023-46,Reefer,20,C,272,64,-208
2023-46,Reefer,20,D,0,16,16
2023-46,Reefer,20,E,128,80,-48
2023-46,Reefer,20,F,112,0,-112
2023-46,Reefer,20,G,16,0,-16
2023-46,Reefer,40,A,20864,5520,-15344
2023-46,Reefer,40,B,7472,6784,-688
2023-46,Reefer,40,C,16592,13488,-3104
2023-46,Reefer,40,D,32,0,-32
2023-46,Reefer,40,E,2112,416,-1696
2023-46,Reefer,40,F,2832,512,-2320
2023-46,Reefer,40,G,12176,784,-11392
2023-47,Dry,20,A,54432,28320,-26112
2023-47,Dry,20,B,75856,93408,17552
2023-47,Dry,20,C,21072,26832,5760
2023-47,Dry,20,D,416,4128,3712
2023-47,Dry,20,E,13280,12320,-960
2023-47,Dry,20,F,8128,3744,-4384
2023-47,Dry,20,G,29664,8256,-21408
2023-47,Dry,40,A,61008,67120,6112
2023-47,Dry,40,B,121936,109536,-12400
2023-47,Dry,40,C,19712,39568,19856
2023-47,Dry,40,D,2448,96,-2352
2023-47,Dry,40,E,20544,17488,-3056
2023-47,Dry,40,F,16816,9424,-7392
2023-47,Dry,40,G,20992,24208,3216
2023-47,Reefer,20,A,224,48,-176
2023-47,Reefer,20,B,272,176,-96
2023-47,Reefer,20,C,192,96,-96
2023-47,Reefer,20,E,160,48,-112
2023-47,Reefer,20,F,400,32,-368
2023-47,Reefer,20,G,0,112,112
2023-47,Reefer,40,A,12416,5200,-7216
2023-47,Reefer,40,B,13584,16416,2832
2023-47,Reefer,40,C,15136,12832,-2304
2023-47,Reefer,40,D,16,0,-16
2023-47,Reefer,40,E,1760,528,-1232
2023-47,Reefer,40,F,3920,384,-3536
2023-47,Reefer,40,G,7248,3936,-3312
2023-48,Dry,20,A,70496,20240,-50256
2023-48,Dry,20,B,102016,122528,20512
2023-48,Dry,20,C,16848,26864,10016
2023-48,Dry,20,D,0,1712,1712
2023-48,Dry,20,E,21024,18096,-2928
2023-48,Dry,20,F,7440,5440,-2000
2023-48,Dry,20,G,28368,6512,-21856
2023-48,Dry,40,A,82544,43008,-39536
2023-48,Dry,40,B,121328,173568,52240
2023-48,Dry,40,C,20416,39216,18800
2023-48,Dry,40,D,1296,48,-1248
2023-48,Dry,40,E,33520,25984,-7536
2023-48,Dry,40,F,17232,15008,-2224
2023-48,Dry,40,G,20304,23424,3120
2023-48,Reefer,20,A,480,16,-464
2023-48,Reefer,20,B,400,496,96
2023-48,Reefer,20,C,272,208,-64
2023-48,Reefer,20,D,32,0,-32
2023-48,Reefer,20,E,176,0,-176
2023-48,Reefer,20,F,224,16,-208
2023-48,Reefer,20,G,48,0,-48
2023-48,Reefer,40,A,16464,1888,-14576
2023-48,Reefer,40,B,13184,16320,3136
2023-48,Reefer,40,C,14384,8512,-5872
2023-48,Reefer,40,D,16,0,-16
2023-48,Reefer,40,E,2928,528,-2400
2023-48,Reefer,40,F,2288,480,-1808
2023-48,Reefer,40,G,9152,2448,-6704
2023-49,Dry,20,A,39440,24064,-15376
2023-49,Dry,20,B,107200,113856,6656
2023-49,Dry,20,C,17344,27616,10272
2023-49,Dry,20,E,15360,15136,-224
2023-49,Dry,20,F,5952,2560,-3392
2023-49,Dry,20,G,25536,8000,-17536
2023-49,Dry,40,A,58768,43568,-15200
2023-49,Dry,40,B,142016,142752,736
2023-49,Dry,40,C,22464,35904,13440
2023-49,Dry,40,D,352,16,-336
2023-49,Dry,40,E,19616,20448,832
2023-49,Dry,40,F,12752,6192,-6560
2023-49,Dry,40,G,12864,23856,10992
2023-49,Reefer,20,A,704,32,-672
2023-49,Reefer,20,B,208,432,224
2023-49,Reefer,20,C,192,304,112
2023-49,Reefer,20,E,112,32,-80
2023-49,Reefer,20,F,16,0,-16
2023-49,Reefer,20,G,16,16,0
2023-49,Reefer,40,A,16928,4144,-12784
2023-49,Reefer,40,B,12864,16240,3376
2023-49,Reefer,40,C,10800,15120,4320
2023-49,Reefer,40,E,2272,480,-1792
2023-49,Reefer,40,F,2064,640,-1424
2023-49,Reefer,40,G,5072,1984,-3088
2023-50,Dry,20,A,63632,32528,-31104
2023-50,Dry,20,B,115968,96144,-19824
2023-50,Dry,20,C,14608,48256,33648
2023-50,Dry,20,D,0,4128,4128
2023-50,Dry,20,E,16656,13648,-3008
2023-50,Dry,20,F,8112,6640,-1472
2023-50,Dry,20,G,15040,10128,-4912
2023-50,Dry,40,A,71824,65632,-6192
2023-50,Dry,40,B,144624,105296,-39328
2023-50,Dry,40,C,19632,48128,28496
2023-50,Dry,40,D,800,64,-736
2023-50,Dry,40,E,24144,17872,-6272
2023-50,Dry,40,F,17936,12448,-5488
2023-50,Dry,40,G,12864,27488,14624
2023-50,Reefer,20,A,528,16,-512
2023-50,Reefer,20,B,512,272,-240
2023-50,Reefer,20,C,192,208,16
2023-50,Reefer,20,E,80,16,-64
2023-50,Reefer,20,F,272,32,-240
2023-50,Reefer,20,G,80,160,80
2023-50,Reefer,40,A,19552,6032,-13520
2023-50,Reefer,40,B,21136,28592,7456
2023-50,Reefer,40,C,10304,20736,10432
2023-50,Reefer,40,D,32,16,-16
2023-50,Reefer,40,E,1440,416,-1024
2023-50,Reefer,40,F,2320,512,-1808
2023-50,Reefer,40,G,6576,3200,-3376
2023-51,Dry,20,A,58048,30688,-27360
2023-51,Dry,20,B,82080,103472,21392
2023-51,Dry,20,C,17600,20432,2832
2023-51,Dry,20,D,368,80,-288
2023-51,Dry,20,E,22064,11600,-10464
2023-51,Dry,20,F,6880,8896,2016
2023-51,Dry,20,G,30512,5696,-24816
2023-51,Dry,40,A,78800,47920,-30880
2023-51,Dry,40,B,111232,152288,41056
2023-51,Dry,40,C,22832,24432,1600
2023-51,Dry,40,D,784,112,-672
2023-51,Dry,40,E,35600,11152,-24448
2023-51,Dry,40,F,19104,19104,0
2023-51,Dry,40,G,17456,22752,5296
2023-51,Reefer,20,A,800,0,-800
2023-51,Reefer,20,B,336,368,32
2023-51,Reefer,20,C,224,64,-160
2023-51,Reefer,20,E,160,16,-144
2023-51,Reefer,20,F,256,48,-208
2023-51,Reefer,20,G,64,0,-64
2023-51,Reefer,40,A,15040,1504,-13536
2023-51,Reefer,40,B,23584,12560,-11024
2023-51,Reefer,40,C,7328,7968,640
2023-51,Reefer,40,D,0,32,32
2023-51,Reefer,40,E,2848,1152,-1696
2023-51,Reefer,40,F,3568,736,-2832
2023-51,Reefer,40,G,7008,3424,-3584
